aaaacbbdaa	TRUE
aaaaccbdaa	FALSE
aabbdcdcdbdbaababcbacddccacd	TRUE
aadbdcdcdbdbaababcbacddccacd	FALSE
abbcdaaaac	TRUE
abcdaaaac	FALSE
abbab	TRUE
aabab	FALSE
abbd	TRUE
aabd	FALSE
abaabbac	TRUE
abaabcbac	FALSE
abddcbbadba	TRUE
abddcbabadba	FALSE
abbd	TRUE
acbd	FALSE
abbccc	TRUE
adbccc	FALSE
abb	TRUE
adb	FALSE
acbbdbd	TRUE
acdbdbd	FALSE
adbb	TRUE
adab	FALSE
addbbcb	TRUE
addbcb	FALSE
bbababadbcdd	TRUE
bababadbcdd	FALSE
bbaccda	TRUE
baccda	FALSE
bba	TRUE
ba	FALSE
bbcadcca	TRUE
bcadcca	FALSE
bbcb	TRUE
bcb	FALSE
bbcdcc	TRUE
bcdcc	FALSE
bbdaabd	TRUE
bdaabd	FALSE
bbdbd	TRUE
bdbd	FALSE
bbddbcdb	TRUE
bddbcdb	FALSE
bbd	TRUE
bd	FALSE
bb	TRUE
b	FALSE
bb	TRUE
b	FALSE
bb	TRUE
b	FALSE
bbaa	TRUE
abaa	FALSE
bbacd	TRUE
abacd	FALSE
bba	TRUE
aba	FALSE
bbcbaababc	TRUE
abcbaababc	FALSE
bbcccccbcadabaddadb	TRUE
abcccccbcadabaddadb	FALSE
bbcd	TRUE
abcd	FALSE
bbdacac	TRUE
abdacac	FALSE
bbdb	TRUE
abdb	FALSE
bbddc	TRUE
abddc	FALSE
bb	TRUE
ab	FALSE
bb	TRUE
ab	FALSE
bb	TRUE
ab	FALSE
bbaacadccbddcaab	TRUE
babaacadccbddcaab	FALSE
bb	TRUE
bab	FALSE
bbdbccdcdcadad	TRUE
bcbdbccdcdcadad	FALSE
bbc	TRUE
bdbc	FALSE
babbadb	TRUE
baabadb	FALSE
bbacdda	TRUE
bacdda	FALSE
bb	TRUE
b	FALSE
bbddbd	TRUE
baddbd	FALSE
bbc	TRUE
bcc	FALSE
bbdaacdbcdadc	TRUE
bddaacdbcdadc	FALSE
bcbabbacacabaad	TRUE
bcbabcacacabaad	FALSE
bdbb	TRUE
bdb	FALSE
bbaab	TRUE
cbaab	FALSE
bbab	TRUE
cbab	FALSE
bbadcbd	TRUE
cbadcbd	FALSE
bbcabcc	TRUE
cbcabcc	FALSE
bbcb	TRUE
cbcb	FALSE
bbcdbcaabddc	TRUE
cbcdbcaabddc	FALSE
bbc	TRUE
cbc	FALSE
bbdbca	TRUE
cbdbca	FALSE
bbdc	TRUE
cbdc	FALSE
bbd	TRUE
cbd	FALSE
bb	TRUE
cb	FALSE
bb	TRUE
cb	FALSE
bb	TRUE
cb	FALSE
bbaa	TRUE
dbaa	FALSE
bbaccdddcc	TRUE
dbaccdddcc	FALSE
bba	TRUE
dba	FALSE
bbcac	TRUE
dbcac	FALSE
bbcca	TRUE
dbcca	FALSE
bbcddcdadad	TRUE
dbcddcdadad	FALSE
bbdaca	TRUE
dbdaca	FALSE
bbdcaadcaddd	TRUE
dbdcaadcaddd	FALSE
bbdddc	TRUE
dbdddc	FALSE
bb	TRUE
db	FALSE
bb	TRUE
db	FALSE
bb	TRUE
db	FALSE
caabb	TRUE
caaab	FALSE
cabb	TRUE
cacb	FALSE
cbbaddbcad	TRUE
cbaddbcad	FALSE
cbb	TRUE
cb	FALSE
cbbc	TRUE
cabc	FALSE
cbb	TRUE
cbcb	FALSE
cbbdc	TRUE
cbddc	FALSE
cbbcca	TRUE
ccbcca	FALSE
cbb	TRUE
ccb	FALSE
cbbdda	TRUE
cdbdda	FALSE
ccbbdcacdda	TRUE
ccabdcacdda	FALSE
ccdcbbd	TRUE
ccdcdbd	FALSE
cdbbdbdacdda	TRUE
cdcbdbdacdda	FALSE
dabbcadacd	TRUE
daabcadacd	FALSE
dacbcbb	TRUE
dacbcab	FALSE
dbbcd	TRUE
dbcd	FALSE
dbbaccccd	TRUE
dabaccccd	FALSE
dbb	TRUE
dab	FALSE
dbbd	TRUE
dbd	FALSE
dbbac	TRUE
dcbac	FALSE
dbb	TRUE
dcb	FALSE
dbbcca	TRUE
ddbcca	FALSE
dcabbdb	TRUE
dcaabdb	FALSE
dcbbcabab	TRUE
dcdbcabab	FALSE
ddbbdcd	TRUE
ddabdcd	FALSE
aaaabb	TRUE
aaaab	FALSE
aabbca	TRUE
aadbca	FALSE
abbcbc	TRUE
abcbc	FALSE
abbaba	TRUE
aababa	FALSE
abbdad	TRUE
aabdad	FALSE
abadbb	TRUE
abadb	FALSE
abbaaa	TRUE
acbaaa	FALSE
abbcdc	TRUE
acbcdc	FALSE
abbada	TRUE
adbada	FALSE
abbdba	TRUE
adbdba	FALSE
acbbda	TRUE
acabda	FALSE
acdcbb	TRUE
acdccb	FALSE
adbbaa	TRUE
addbaa	FALSE
bbaabd	TRUE
baabd	FALSE
bbabcb	TRUE
babcb	FALSE
bbacbd	TRUE
bacbd	FALSE
bbadbc	TRUE
badbc	FALSE
bbcaba	TRUE
bcaba	FALSE
bbcbac	TRUE
bcbac	FALSE
bbccac	TRUE
bccac	FALSE
bbccd	TRUE
bccd	FALSE
bbcddd	TRUE
bcddd	FALSE
bbdad	TRUE
bdad	FALSE
bbdbdc	TRUE
bdbdc	FALSE
bbdcda	TRUE
bdcda	FALSE
bbddc	TRUE
bddc	FALSE
bbaada	TRUE
abaada	FALSE
bbabda	TRUE
ababda	FALSE
bbacb	TRUE
abacb	FALSE
bbadb	TRUE
abadb	FALSE
bbcaca	TRUE
abcaca	FALSE
bbcbda	TRUE
abcbda	FALSE
bbccda	TRUE
abccda	FALSE
bbcdc	TRUE
abcdc	FALSE
bbdacd	TRUE
abdacd	FALSE
bbdbdd	TRUE
abdbdd	FALSE
bbdcdb	TRUE
abdcdb	FALSE
bbddcc	TRUE
abddcc	FALSE
bbcdaa	TRUE
babcdaa	FALSE
bbcacc	TRUE
bcbcacc	FALSE
bbcaa	TRUE
bdbcaa	FALSE
babbca	TRUE
babca	FALSE
badcbb	TRUE
badcb	FALSE
bbdbab	TRUE
bdbab	FALSE
bbccca	TRUE
baccca	FALSE
bbbdcd	TRUE
bcbdcd	FALSE
bbbab	TRUE
bdbab	FALSE
bcabba	TRUE
bcaaba	FALSE
bccbbc	TRUE
bccbc	FALSE
bdbcbb	TRUE
bdbcab	FALSE
bbaaa	TRUE
cbaaa	FALSE
bbabab	TRUE
cbabab	FALSE
bbacad	TRUE
cbacad	FALSE
bbacd	TRUE
cbacd	FALSE
bbcaaa	TRUE
cbcaaa	FALSE
bbcbaa	TRUE
cbcbaa	FALSE
bbcbdd	TRUE
cbcbdd	FALSE
bbccdd	TRUE
cbccdd	FALSE
bbcdda	TRUE
cbcdda	FALSE
bbdada	TRUE
cbdada	FALSE
bbdbc	TRUE
cbdbc	FALSE
bbdccb	TRUE
cbdccb	FALSE
bbddcc	TRUE
cbddcc	FALSE
bbaab	TRUE
dbaab	FALSE
bbabcd	TRUE
dbabcd	FALSE
bbacca	TRUE
dbacca	FALSE
bbadb	TRUE
dbadb	FALSE
bbcaba	TRUE
dbcaba	FALSE
bbcbad	TRUE
dbcbad	FALSE
bbcca	TRUE
dbcca	FALSE
bbcdaa	TRUE
dbcdaa	FALSE
bbcddd	TRUE
dbcddd	FALSE
bbdbaa	TRUE
dbdbaa	FALSE
bbdbd	TRUE
dbdbd	FALSE
bbdcdb	TRUE
dbdcdb	FALSE
bbddc	TRUE
dbddc	FALSE
cabbca	TRUE
cacbca	FALSE
cbbada	TRUE
cbada	FALSE
cbbdb	TRUE
cbdb	FALSE
cbbcbc	TRUE
cabcbc	FALSE
cbbcbc	TRUE
cbabcbc	FALSE
cbbcb	TRUE
cbccb	FALSE
cbbcad	TRUE
ccbcad	FALSE
cbbaab	TRUE
cdbaab	FALSE
cbbcd	TRUE
cdbcd	FALSE
ccbbad	TRUE
ccabad	FALSE
cdabba	TRUE
cdaba	FALSE
cdbbac	TRUE
cddbac	FALSE
dabbaa	TRUE
daabaa	FALSE
dacbbd	TRUE
dacbd	FALSE
dbbcad	TRUE
dbcad	FALSE
dbbddc	TRUE
dbddc	FALSE
dbbcc	TRUE
dabcc	FALSE
dbbca	TRUE
dbdbca	FALSE
dbdbb	TRUE
dbddb	FALSE
dbbcdd	TRUE
dcbcdd	FALSE
dbbcad	TRUE
ddbcad	FALSE
dcabb	TRUE
dcaab	FALSE
dcbbcd	TRUE
dcdbcd	FALSE
ddbbdc	TRUE
ddabdc	FALSE
aaaabbabadc	TRUE
aaaababadc	FALSE
aabbabddddb	TRUE
aadbabddddb	FALSE
abbcabcbacb	TRUE
abcabcbacb	FALSE
abbabadcaab	TRUE
aababadcaab	FALSE
abbdadcacca	TRUE
aabdadcacca	FALSE
abacbbcdbdb	TRUE
abacbcdbdb	FALSE
abbaaacaada	TRUE
acbaaacaada	FALSE
abbdaacbabc	TRUE
acbdaacbabc	FALSE
abbacaaaddc	TRUE
adbacaaaddc	FALSE
abbdbabdaac	TRUE
adbdbabdaac	FALSE
acbbcbdbadd	TRUE
acabcbdbadd	FALSE
acddbbadbdd	TRUE
acddcbadbdd	FALSE
adbbabadaac	TRUE
addbabadaac	FALSE
bbaabcccab	TRUE
baabcccab	FALSE
bbababdcddb	TRUE
bababdcddb	FALSE
bbacabccbca	TRUE
bacabccbca	FALSE
bbadaacaada	TRUE
badaacaada	FALSE
bbaddadddaa	TRUE
baddadddaa	FALSE
bbcadcdabcb	TRUE
bcadcdabcb	FALSE
bbcbddbcdba	TRUE
bcbddbcdba	FALSE
bbccdcddcbc	TRUE
bccdcddcbc	FALSE
bbcddbaccdb	TRUE
bcddbaccdb	FALSE
bbdacdbcdcd	TRUE
bdacdbcdcd	FALSE
bbdbcdbabaa	TRUE
bdbcdbabaa	FALSE
bbdccdabdcd	TRUE
bdccdabdcd	FALSE
bbddcdbccdc	TRUE
bddcdbccdc	FALSE
bbaadaaadab	TRUE
abaadaaadab	FALSE
bbabdacbabc	TRUE
ababdacbabc	FALSE
bbacccbacd	TRUE
abacccbacd	FALSE
bbaddaacbad	TRUE
abaddaacbad	FALSE
bbcacdbabd	TRUE
abcacdbabd	FALSE
bbcbdbcaacb	TRUE
abcbdbcaacb	FALSE
bbccccdcbc	TRUE
abccccdcbc	FALSE
bbcdccbaabc	TRUE
abcdccbaabc	FALSE
bbdacbddccd	TRUE
abdacbddccd	FALSE
bbdbcddcca	TRUE
abdbcddcca	FALSE
bbdcccaccda	TRUE
abdcccaccda	FALSE
bbddcbdbabd	TRUE
abddcbdbabd	FALSE
bbcbdcbacdd	TRUE
babcbdcbacdd	FALSE
bbabdbabcad	TRUE
bcbabdbabcad	FALSE
bbdddabaddb	TRUE
bcbdddabaddb	FALSE
bbdcaaddccd	TRUE
bdbdcaaddccd	FALSE
babbdaaabcc	TRUE
badbdaaabcc	FALSE
bbcbddaacbd	TRUE
bcbddaacbd	FALSE
bbbdacddbca	TRUE
babdacddbca	FALSE
bbadabcccaa	TRUE
bcadabcccaa	FALSE
bbdcdddbcab	TRUE
bcdcdddbcab	FALSE
bbdbacadbd	TRUE
bddbacadbd	FALSE
bcbbbcbadd	TRUE
bcbdbcbadd	FALSE
bdbbdcdcada	TRUE
bdbdcdcada	FALSE
bbaaaccddbd	TRUE
cbaaaccddbd	FALSE
bbababaddbc	TRUE
cbababaddbc	FALSE
bbacadcdbad	TRUE
cbacadcdbad	FALSE
bbadabcbdc	TRUE
cbadabcbdc	FALSE
bbaddbcbcb	TRUE
cbaddbcbcb	FALSE
bbcacdbccbd	TRUE
cbcacdbccbd	FALSE
bbcbdaabadd	TRUE
cbcbdaabadd	FALSE
bbcccdbcdca	TRUE
cbcccdbcdca	FALSE
bbcdcbdbdbc	TRUE
cbcdcbdbdbc	FALSE
bbdacacbdd	TRUE
cbdacacbdd	FALSE
bbdbcdabacc	TRUE
cbdbcdabacc	FALSE
bbdccaadbda	TRUE
cbdccaadbda	FALSE
bbddccbacad	TRUE
cbddccbacad	FALSE
bbaacacdbac	TRUE
dbaacacdbac	FALSE
bbabcbabaac	TRUE
dbabcbabaac	FALSE
bbacbcbdabd	TRUE
dbacbcbdabd	FALSE
bbadbcacdbc	TRUE
dbadbcacdbc	FALSE
bbcaadadccc	TRUE
dbcaadadccc	FALSE
bbcbaabadcb	TRUE
dbcbaabadcb	FALSE
bbcbdcbccbd	TRUE
dbcbdcbccbd	FALSE
bbccdbadbdc	TRUE
dbccdbadbdc	FALSE
bbcddabaadd	TRUE
dbcddabaadd	FALSE
bbdacdbdba	TRUE
dbdacdbdba	FALSE
bbdbdbadcbd	TRUE
dbdbdbadcbd	FALSE
bbdcdbdabda	TRUE
dbdcdbdabda	FALSE
bbdddcbadd	TRUE
dbdddcbadd	FALSE
cabdbbdaaab	TRUE
cabdbdaaab	FALSE
cbbabccbacc	TRUE
cbabccbacc	FALSE
cbbdcaaacba	TRUE
cbdcaaacba	FALSE
cbbccadbcba	TRUE
cabccadbcba	FALSE
cbbaabaddda	TRUE
cbdbaabaddda	FALSE
cbcbbcbcddd	TRUE
cbccbcbcddd	FALSE
cbbcbcadcdc	TRUE
ccbcbcadcdc	FALSE
cbbabacbabd	TRUE
cdbabacbabd	FALSE
cbbdbdaadbc	TRUE
cdbdbdaadbc	FALSE
ccbbddbdaab	TRUE
ccabddbdaab	FALSE
cdaaabbaacd	TRUE
cdaaabaacd	FALSE
cdbbdbccdba	TRUE
cdcbdbccdba	FALSE
dabbabcaaad	TRUE
daababcaaad	FALSE
daccbbacbcd	TRUE
daccabacbcd	FALSE
dbbcdbddccc	TRUE
dbcdbddccc	FALSE
dbbacccbcbc	TRUE
dabacccbcbc	FALSE
dbbdbddddac	TRUE
dabdbddddac	FALSE
dbbdbacdaca	TRUE
dbdbacdaca	FALSE
dbbaacbdba	TRUE
dcbaacbdba	FALSE
dbbdabddbcc	TRUE
dcbdabddbcc	FALSE
dbbcacadada	TRUE
ddbcacadada	FALSE
dcaabbcaaaa	TRUE
dcaabcaaaa	FALSE
dcbbdcbdbac	TRUE
dcdbdcbdbac	FALSE
ddbbdcaaddb	TRUE
ddabdcaaddb	FALSE
aaaabbdccbdbabac	TRUE
aaaabdccbdbabac	FALSE
aabbaaaabaccddba	TRUE
aadbaaaabaccddba	FALSE
abbadbdaddcdacad	TRUE
abadbdaddcdacad	FALSE
abbddaddabcdddac	TRUE
abddaddabcdddac	FALSE
abbcdaaaaabdabd	TRUE
aabcdaaaaabdabd	FALSE
abbadacdabdcccdb	TRUE
abdbadacdabdcccdb	FALSE
abcbbccdadbdcbca	TRUE
abcbccdadbdcbca	FALSE
abbcbcbaaabdccdd	TRUE
acbcbcbaaabdccdd	FALSE
abbabdbadcdbcdcb	TRUE
adbabdbadcdbcdcb	FALSE
abbdadddacabcacd	TRUE
adbdadddacabcacd	FALSE
acbbabacdaddbdc	TRUE
acbababacdaddbdc	FALSE
adabbcbabcbaccbc	TRUE
adadbcbabcbaccbc	FALSE
adbbdbddccdcbdc	TRUE
addbdbddccdcbdc	FALSE
bbaacaaddaddaccd	TRUE
baacaaddaddaccd	FALSE
bbabcccdcbcbadb	TRUE
babcccdcbcbadb	FALSE
bbacbddbdccdbdbc	TRUE
bacbddbdccdbdbc	FALSE
bbadbdbaccbccaab	TRUE
badbdbaccbccaab	FALSE
bbcabccacadaadda	TRUE
bcabccacadaadda	FALSE
bbcbaddadadccbcd	TRUE
bcbaddadadccbcd	FALSE
bbccacccacabcbcd	TRUE
bccacccacabcbcd	FALSE
bbcdabccbdabccab	TRUE
bcdabccbdabccab	FALSE
bbdaadbccdaacbdc	TRUE
bdaadbccdaacbdc	FALSE
bbdbadaddaabaca	TRUE
bdbadaddaabaca	FALSE
bbdcbabacdcdbdba	TRUE
bdcbabacdcdbdba	FALSE
bbddadadddbadcab	TRUE
bddadadddbadcab	FALSE
bbaaacbcabacacaa	TRUE
abaaacbcabacacaa	FALSE
bbabaacacaccbdca	TRUE
ababaacacaccbdca	FALSE
bbacaaccddbaacbd	TRUE
abacaaccddbaacbd	FALSE
bbacddddaadaaddc	TRUE
abacddddaadaaddc	FALSE
bbaddcbcabdcabdc	TRUE
abaddcbcabdcabdc	FALSE
bbcadbabdbdbcbac	TRUE
abcadbabdbdbcbac	FALSE
bbcbdccccadbddc	TRUE
abcbdccccadbddc	FALSE
bbcdaaadaaddbddc	TRUE
abcdaaadaaddbddc	FALSE
bbcddacdcccdaddd	TRUE
abcddacdcccdaddd	FALSE
bbdadacddacccbad	TRUE
abdadacddacccbad	FALSE
bbdbdabadaddaadc	TRUE
abdbdabadaddaadc	FALSE
bbdccbaddcbcddad	TRUE
abdccbaddcbcddad	FALSE
bbddcbabcdcdddad	TRUE
abddcbabcdcdddad	FALSE
bbcbabdaadaabdbc	TRUE
babcbabdaadaabdbc	FALSE
bbcaacabacbaacba	TRUE
bcbcaacabacbaacba	FALSE
bbabcababdabcbdc	TRUE
bdbabcababdabcbdc	FALSE
baaacdadbbacbcad	TRUE
baaacdadbacbcad	FALSE
bacbbaccaccdcaa	TRUE
bacdbaccaccdcaa	FALSE
bbccddaccabdccbd	TRUE
bccddaccabdccbd	FALSE
bbbcdbcabcdcaccc	TRUE
babcdbcabcdcaccc	FALSE
bbbcacabcccabcdc	TRUE
bcbcacabcccabcdc	FALSE
bbadcabcbadbcddb	TRUE
bdadcabcbadbcddb	FALSE
bbddaddabcbaabad	TRUE
bdddaddabcbaabad	FALSE
bccbcbbcabdacaab	TRUE
bccbcdbcabdacaab	FALSE
bdbbcbdcbaaabdbd	TRUE
bdcbcbdcbaaabdbd	FALSE
bbaaaddabdbadad	TRUE
cbaaaddabdbadad	FALSE
bbabadabdacaaccc	TRUE
cbabadabdacaaccc	FALSE
bbacbadddaccbddb	TRUE
cbacbadddaccbddb	FALSE
bbadaccaabadbcb	TRUE
cbadaccaabadbcb	FALSE
bbcaabdcddaddadd	TRUE
cbcaabdcddaddadd	FALSE
bbcbacabadbaadca	TRUE
cbcbacabadbaadca	FALSE
bbccaaddccacbdbd	TRUE
cbccaaddccacbdbd	FALSE
bbccddbaccbaccb	TRUE
cbccddbaccbaccb	FALSE
bbcddddcdcbcbcad	TRUE
cbcddddcdcbcbcad	FALSE
bbdadbadcbabdacc	TRUE
cbdadbadcbabdacc	FALSE
bbdbdcccbdccacbd	TRUE
cbdbdcccbdccacbd	FALSE
bbdcdcddabdababd	TRUE
cbdcdcddabdababd	FALSE
bbdddcaabdaadcda	TRUE
cbdddcaabdaadcda	FALSE
bbaadabdabcadcab	TRUE
dbaadabdabcadcab	FALSE
bbabdabcdadddcd	TRUE
dbabdabcdadddcd	FALSE
bbaccdbadbaabacb	TRUE
dbaccdbadbaabacb	FALSE
bbadcbdcdbcabab	TRUE
dbadcbdcdbcabab	FALSE
bbcacbadddacdddd	TRUE
dbcacbadddacdddd	FALSE
bbcbcccdabaccdcc	TRUE
dbcbcccdabaccdcc	FALSE
bbccbcdbccdcbab	TRUE
dbccbcdbccdcbab	FALSE
bbcdbcccdcbdcdbd	TRUE
dbcdbcccdcbdcdbd	FALSE
bbdaacadacacabad	TRUE
dbdaacadacacabad	FALSE
bbdbacccdaacddcc	TRUE
dbdbacccdaacddcc	FALSE
bbdcbadabcadaaad	TRUE
dbdcbadabcadaaad	FALSE
bbddbcadbcdcadab	TRUE
dbddbcadbcdcadab	FALSE
cabbabddaadabcbd	TRUE
caababddaadabcbd	FALSE
cadbbdaacabdbaaa	TRUE
cadbcbdaacabdbaaa	FALSE
cbbcdabcbadadac	TRUE
cbcdabcbadadac	FALSE
cbbababaacadbca	TRUE
cabababaacadbca	FALSE
cbbdaddcdcbddbdd	TRUE
cabdaddcdcbddbdd	FALSE
cbaaabbcbcaabad	TRUE
cbaaacbcbcaabad	FALSE
cbcbbcabdbaadbca	TRUE
cbcdbcabdbaadbca	FALSE
cbbcbccadcbdbdc	TRUE
ccbcbccadcbdbdc	FALSE
cbbabcbcbcbabcc	TRUE
cdbabcbcbcbabcc	FALSE
cbbdbcbdbcacabcc	TRUE
cdbdbcbdbcacabcc	FALSE
ccbbadddbcbcbad	TRUE
ccbadddbcbcbad	FALSE
cdabbaacbcabdad	TRUE
cdabaacbcabdad	FALSE
cdcbdbbacbcacadc	TRUE
cdcbdabacbcacadc	FALSE
dabcbbcdacadbaca	TRUE
dabcabcdacadbaca	FALSE
dbbabcdbaccddcca	TRUE
dbabcdbaccddcca	FALSE
dbbdbcbcbdbcabc	TRUE
dbdbcbcbdbcabc	FALSE
dbbcbccdbddcaadb	TRUE
dabcbccdbddcaadb	FALSE
dbbabdcdadddcaca	TRUE
dbcbabdcdadddcaca	FALSE
dbcbbccdddbdbcab	TRUE
dbcabccdddbdbcab	FALSE
dbbcaadbadbaddcc	TRUE
dcbcaadbadbaddcc	FALSE
dbbaabaaacddccda	TRUE
ddbaabaaacddccda	FALSE
dbbcdadbcdbcccaa	TRUE
ddbcdadbcdbcccaa	FALSE
dcbbdaacbdccdaca	TRUE
dcbdaacbdccdaca	FALSE
dccddbbddbccbdda	TRUE
dccddabddbccbdda	FALSE
ddbadbbcdbcabcbc	TRUE
ddbadabcdbcabcbc	FALSE
aaaaabbadacdabadbacab	TRUE
aaaaacbadacdabadbacab	FALSE
aabbdaaacbccbaaaccaa	TRUE
aacbdaaacbccbaaaccaa	FALSE
abbaccadadaabaabdbdda	TRUE
abaccadadaabaabdbdda	FALSE
abbdccaaacbdcaaddcbac	TRUE
abdccaaacbdcaaddcbac	FALSE
abbcccdadadbcaaccacbd	TRUE
aabcccdadadbcaaccacbd	FALSE
abbaadddacbdabacdaada	TRUE
abdbaadddacbdabacdaada	FALSE
abcdbbcbdaaaaadaaddba	TRUE
abcddbcbdaaaaadaaddba	FALSE
abbcccdbaaadbababdbd	TRUE
acbcccdbaaadbababdbd	FALSE
abbabdcaabcbdabcadbdc	TRUE
adbabdcaabcbdabcadbdc	FALSE
abbdcacababaabcbaaadd	TRUE
adbdcacababaabcbaaadd	FALSE
acbbaccdbcaccbadddadd	TRUE
acbaaccdbcaccbadddadd	FALSE
adbbcddcbcbdcacabccbc	TRUE
adbcddcbcbdcacabccbc	FALSE
adcbbacdcdcaadabddbaa	TRUE
adcdbacdcdcaadabddbaa	FALSE
bbaadbadbdcdcaacabdd	TRUE
baadbadbdcdcaacabdd	FALSE
bbabcdcacbabddbaabdbd	TRUE
babcdcacbabddbaabdbd	FALSE
bbaccbcabdbaacacaacbc	TRUE
baccbcabdbaacacaacbc	FALSE
bbadcaadbababaacccddc	TRUE
badcaadbababaacccddc	FALSE
bbcaaddabdbcddbdbcaa	TRUE
bcaaddabdbcddbdbcaa	FALSE
bbcbacbcbaadbaacbdda	TRUE
bcbacbcbaadbaacbdda	FALSE
bbcbddddccbccccaacbdc	TRUE
bcbddddccbccccaacbdc	FALSE
bbccdcaddbcdbdbccdacc	TRUE
bccdcaddbcdbdbccdacc	FALSE
bbcddaccdddddcabcbadd	TRUE
bcddaccdddddcabcbadd	FALSE
bbdadaabccccccdbcadad	TRUE
bdadaabccccccdbcadad	FALSE
bbdbdaacabcdddddbdba	TRUE
bdbdaacabcdddddbdba	FALSE
bbdccdbcbcbaaabacbdc	TRUE
bdccdbcbcbaaabacbdc	FALSE
bbddccdcadaccdaaabaca	TRUE
bddccdcadaccdaaabaca	FALSE
bbaabddacbccbdbcbddc	TRUE
abaabddacbccbdbcbddc	FALSE
bbabccabacbdbdadccdbd	TRUE
ababccabacbdbdadccdbd	FALSE
bbacbdbddbdadccacbadc	TRUE
abacbdbddbdadccacbadc	FALSE
bbadbdbdaaaacadbadcdb	TRUE
abadbdbdaaaacadbadcdb	FALSE
bbcabaccaaddcbaabdbac	TRUE
abcabaccaaddcbaabdbac	FALSE
bbcbaccbcdadaadcbabdd	TRUE
abcbaccbcdadaadcbabdd	FALSE
bbccadbacdacbccaaacdb	TRUE
abccadbacdacbccaaacdb	FALSE
bbcdacadddcaddbcbabc	TRUE
abcdacadddcaddbcbabc	FALSE
bbdaacbccccdaddcdcbdd	TRUE
abdaacbccccdaddcdcbdd	FALSE
bbdbabccddbddbccdcbdb	TRUE
abdbabccddbddbccdcbdb	FALSE
bbdcaaacaaacadcbddcdd	TRUE
abdcaaacaaacadcbddcdd	FALSE
bbdcdccbacababadbcba	TRUE
abdcdccbacababadbcba	FALSE
bbdddbadcdbcbadbabcb	TRUE
abdddbadcdbcbadbabcb	FALSE
bbcccccbaabcaabaddacb	TRUE
babcccccbaabcaabaddacb	FALSE
bbcbcbabddaaccadabcca	TRUE
bcbcbcbabddaaccadabcca	FALSE
bbadbdacabaabadaaccaa	TRUE
bdbadbdacabaabadaaccaa	FALSE
baabbdddbadcbcbdacdac	TRUE
baadbdddbadcbcbdacdac	FALSE
badbbcabcdabdcadacbcc	TRUE
baddbcabcdabdcadacbcc	FALSE
bbdbccadabccacdacbdc	TRUE
bdbccadabccacdacbdc	FALSE
bbbdbabdaddacacacadcd	TRUE
babdbabdaddacacacadcd	FALSE
bbacdcbcccbcadbcaabd	TRUE
bcacdcbcccbcadbcaabd	FALSE
bbabacbddbcbdbdbacbad	TRUE
bdabacbddbcbdbdbacbad	FALSE
bbdddccabadabcbcaccbd	TRUE
bddddccabadabcbcaccbd	FALSE
bccbbcaaacdcbaaacddba	TRUE
bcccbcaaacdcbaaacddba	FALSE
bdbbddbcaadbdaccdadcc	TRUE
bddbddbcaadbdaccdadcc	FALSE
bbaacacadcbacdbcdcacc	TRUE
cbaacacadcbacdbcdcacc	FALSE
bbabcbddcabacdacddbca	TRUE
cbabcbddcabacdacddbca	FALSE
bbaccbadaddabdaaaadaa	TRUE
cbaccbadaddabdaaaadaa	FALSE
bbadcabcabaababccabac	TRUE
cbadcabcabaababccabac	FALSE
bbcabdaadcbcccabacadb	TRUE
cbcabdaadcbcccabacadb	FALSE
bbcbcabaadcccddabdcdb	TRUE
cbcbcabaadcccddabdcdb	FALSE
bbccbdadddacbdbcdbddd	TRUE
cbccbdadddacbdbcdbddd	FALSE
bbcdadaccacacadcdadac	TRUE
cbcdadaccacacadcdadac	FALSE
bbdababccabdcccbacdbd	TRUE
cbdababccabdcccbacdbd	FALSE
bbdbadcccbddaabdbdda	TRUE
cbdbadcccbddaabdbdda	FALSE
bbdcbaaccdbaaadbcadbd	TRUE
cbdcbaaccdbaaadbcadbd	FALSE
bbddbcbcbadcbdbcdcaba	TRUE
cbddbcbcbadcbdbcdcaba	FALSE
bbaabcbcbccadaddababd	TRUE
dbaabcbcbccadaddababd	FALSE
bbabadabdaadcbcddcba	TRUE
dbabadabdaadcbcddcba	FALSE
bbacaddbadaaacbddabab	TRUE
dbacaddbadaaacbddabab	FALSE
bbadadbabaaaaaaaaabdc	TRUE
dbadadbabaaaaaaaaabdc	FALSE
bbcaadadbaadcbaaaaaba	TRUE
dbcaadadbaadcbaaaaaba	FALSE
bbcbabcbcacaabdaadcad	TRUE
dbcbabcbcacaabdaadcad	FALSE
bbccaadbabdbdbddddaac	TRUE
dbccaadbabdbdbddddaac	FALSE
bbcdacadbdddbacdbdabd	TRUE
dbcdacadbdddbacdbdabd	FALSE
bbdaaabcdcccdacadcddc	TRUE
dbdaaabcdcccdacadcddc	FALSE
bbdadaddbdaddcbdcdbab	TRUE
dbdadaddbdaddcbdcdbab	FALSE
bbdbdbaaabaddaccabcbd	TRUE
dbdbdbaaabaddaccabcbd	FALSE
bbdcccdbdaadababadcbc	TRUE
dbdcccdbdaadababadcbc	FALSE
bbddccbcbcbcdccddbdba	TRUE
dbddccbcbcbcdccddbdba	FALSE
cabbaacbdbcbcccbabcbc	TRUE
cacbaacbdbcbcccbabcbc	FALSE
cbbaaaddcbddccdcdaadb	TRUE
cbaaaddcbddccdcdaadb	FALSE
cbbdadaccadacddabdbcc	TRUE
cbdadaccadacddabdbcc	FALSE
cbbcabdcbcacbcdcdcbdb	TRUE
cabcabdcbcacbcdcdcbdb	FALSE
cbbddbababccbcacbdaad	TRUE
cabddbababccbcacbdaad	FALSE
cbbaabadcdaccbdabcdbc	TRUE
cbcaabadcdaccbdabcdbc	FALSE
cbbadaacaccbabaabddaa	TRUE
ccbadaacaccbabaabddaa	FALSE
cbbdcbabadcbcbdbddab	TRUE
ccbdcbabadcbcbdbddab	FALSE
cbbcbdbaaadbdccabcdaa	TRUE
cdbcbdbaaadbdccabcdaa	FALSE
ccabbacaaabdacbdbccb	TRUE
ccabacaaabdacbdbccb	FALSE
ccbbdbcdbdadacbcabdac	TRUE
ccdbdbcdbdadacbcabdac	FALSE
cdbbcaabacabdabadabdc	TRUE
cdbcaabacabdabadabdc	FALSE
daabbdabcdaccaddddada	TRUE
daaabdabcdaccaddddada	FALSE
dabbdddccccadccbdadd	TRUE
dacbdddccccadccbdadd	FALSE
dbbacdacdbcddaacadbc	TRUE
dbacdacdbcddaacadbc	FALSE
dbbdcdcddbdcadbabcdbc	TRUE
dbdcdcddbdcadbabcdbc	FALSE
dbbccddabccbdbabcaddd	TRUE
dabccddabccbdbabcaddd	FALSE
dbbaaabdadadbaccdcbda	TRUE
dbdbaaabdadadbaccdcbda	FALSE
dbdadbbadacbccaabaaa	TRUE
dbdaddbadacbccaabaaa	FALSE
dbbccccbacadbacbacbab	TRUE
dcbccccbacadbacbacbab	FALSE
dbbacccbdbabdddbdccd	TRUE
ddbacccbdbabdddbdccd	FALSE
dbbdddddddcccbdbdabcd	TRUE
ddbdddddddcccbdbdabcd	FALSE
dcbbcacadaadcbddddbdc	TRUE
dcdbcacadaadcbddddbdc	FALSE
ddbbcbdcbdbddcccbddcc	TRUE
ddabcbdcbdbddcccbddcc	FALSE
aaaabbaadaadddccbacadaddcd	TRUE
aaaaabaadaadddccbacadaddcd	FALSE
aabbddbdaddcbcabcdaabdcbda	TRUE
aacbddbdaddcbcabcdaabdcbda	FALSE
abbadcdabdbdcdaabcbcddcacd	TRUE
abadcdabdbdcdaabcbcddcacd	FALSE
abbdddccdcbaacbcdcccbaabdd	TRUE
abdddccdcbaacbcdcccbaabdd	FALSE
abbcdcdaaadbdcbacaababdcac	TRUE
aabcdcdaaadbdcbacaababdcac	FALSE
ababbaacbdbdbaabdabacadcba	TRUE
abaabaacbdbdbaabdabacadcba	FALSE
abbaabadaacabcdbaacaccaaa	TRUE
acbaabadaacabcdbaacaccaaa	FALSE
abbcdbdbabdbdccbadaddcabca	TRUE
acbcdbdbabdbdccbadaddcabca	FALSE
abbadadbdddddddcbcbdcadddb	TRUE
adbadadbdddddddcbcbdcadddb	FALSE
abbdccacbdbccdccbabccaccda	TRUE
adbdccacbdbccdccbabccaccda	FALSE
acbbccbddaaacabaaccabcdddc	TRUE
accbccbddaaacabaaccabcdddc	FALSE
adbbdcaacccdadaddbcadaabdd	TRUE
adbdcaacccdadaddbcadaabdd	FALSE
addbbdaabdccaacabadddbacca	TRUE
addbdaabdccaacabadddbacca	FALSE
bbaadccccddddabddcbdbdcdd	TRUE
baadccccddddabddcbdbdcdd	FALSE
bbabdbdddbddadcbddaaadbadb	TRUE
babdbdddbddadcbddaaadbadb	FALSE
bbacdabdadbccbacadccdbcdc	TRUE
bacdabdadbccbacadccdbcdc	FALSE
bbadccacbdbddcacaadacabacb	TRUE
badccacbdbddcacaadacabacb	FALSE
bbcacbabadbcdabdcccdcabdab	TRUE
bcacbabadbcdabdcccdcabdab	FALSE
bbcbcbcbdbccdcacdccdacabd	TRUE
bcbcbcbdbccdcacdccdacabd	FALSE
bbccbdbadaaabacbcadddcaccb	TRUE
bccbdbadaaabacbcadddcaccb	FALSE
bbcdbabdccbdbdbabacdabcbad	TRUE
bcdbabdccbdbdbabacdabcbad	FALSE
bbdaadaccbdbadccdbadbccada	TRUE
bdaadaccbdbadccdbadbccada	FALSE
bbdbaccabacacbccccdacbaac	TRUE
bdbaccabacacbccccdacbaac	FALSE
bbdcbaaabccbadbcadabcddadc	TRUE
bdcbaaabccbadbcadabcddadc	FALSE
bbddbadbacbcaaaaadcccabab	TRUE
bddbadbacbcaaaaadcccabab	FALSE
bbaabccabdcbababacdbcadddb	TRUE
abaabccabdcbababacdbcadddb	FALSE
bbabcbcacadccdaabdbcbccdaa	TRUE
ababcbcacadccdaabdbcbccdaa	FALSE
bbacbdddcbdaaabaddcbacdbad	TRUE
abacbdddcbdaaabaddcbacdbad	FALSE
bbadcadadaaddccbaddcabaaaa	TRUE
abadcadadaaddccbaddcabaaaa	FALSE
bbcabdbcdabdcdbccbcadcbcbc	TRUE
abcabdbcdabdcdbccbcadcbcbc	FALSE
bbcbcaadcadccababdccdcccca	TRUE
abcbcaadcadccababdccdcccca	FALSE
bbccbacadaadbcacbdbcdbccc	TRUE
abccbacadaadbcacbdbcdbccc	FALSE
bbcdaccacbcacbcacdaaadaad	TRUE
abcdaccacbcacbcacdaaadaad	FALSE
bbdaabdcbaadcaabdcddddcadc	TRUE
abdaabdcbaadcaabdcddddcadc	FALSE
bbdaddaadbdbacdbdadababac	TRUE
abdaddaadbdbacdbdadababac	FALSE
bbdbdcdaabaadadbadbcaaaaaa	TRUE
abdbdcdaabaadadbadbcaaaaaa	FALSE
bbdccdddbcadcdddacacdacbac	TRUE
abdccdddbcadcdddacacdacbac	FALSE
bbdddaadcaabcadbdababcdaca	TRUE
abdddaadcaabcadbdababcdaca	FALSE
bbcccbdcdbabcacdccaccbaaac	TRUE
babcccbdcdbabcacdccaccbaaac	FALSE
bbccbcbadbccacdbcccccdcccb	TRUE
bcbccbcbadbccacdbcccccdcccb	FALSE
bbcacdadcaddbddcbdbaccddba	TRUE
bdbcacdadcaddbddcbdbaccddba	FALSE
babbabadaccaddabdadcdcabdb	TRUE
bababadaccaddabdadcdcabdb	FALSE
bacccbbaaaaaadabacbaacbcad	TRUE
bacccbaaaaaaadabacbaacbcad	FALSE
bbdabcbcbdbcdcbdbadcacaaca	TRUE
bdabcbcbdbcdcbdbadcacaaca	FALSE
bbbcbdbcacacdabcbabcadaada	TRUE
babcbdbcacacdabcbabcadaada	FALSE
bbaddcdccaabaddbdadddcbaad	TRUE
bcaddcdccaabaddbdadddcbaad	FALSE
bbaabacdcccbcdadcbcadbdbdc	TRUE
bdaabacdcccbcdadcbcadbdbdc	FALSE
bbcdbdbcaacaabacbcdaabaaca	TRUE
bdcdbdbcaacaabacbcdaabaaca	FALSE
bcbbcbccbacaddacaccddbddbd	TRUE
bcbcbccbacaddacaccddbddbd	FALSE
bdbbccddabdccabdcdcdcdabdc	TRUE
bdbccddabdccabdcdcdcdabdc	FALSE
bbaaaacabadbabacdacdcdcdaa	TRUE
cbaaaacabadbabacdacdcdcdaa	FALSE
bbaaddcdddaabdbcbaaccbacad	TRUE
cbaaddcdddaabdbcbaaccbacad	FALSE
bbabdadbdbddbddbacbaddaabd	TRUE
cbabdadbdbddbddbacbaddaabd	FALSE
bbaccdadacdbddbdaccacbdbaa	TRUE
cbaccdadacdbddbdaccacbdbaa	FALSE
bbadccdcddaaddabcbacacaaab	TRUE
cbadccdcddaaddabcbacacaaab	FALSE
bbcacabdcbadbcccbdbccdcdb	TRUE
cbcacabdcbadbcccbdbccdcdb	FALSE
bbcbdabcdbddbccbaaccdabdaa	TRUE
cbcbdabcdbddbccbaaccdabdaa	FALSE
bbcccadcbcccabdcccbdbccdca	TRUE
cbcccadcbcccabdcccbdbccdca	FALSE
bbcdbddbdcabacaddaabdcbaad	TRUE
cbcdbddbdcabacaddaabdcbaad	FALSE
bbdacadbdbcaccdadbcbabdcdb	TRUE
cbdacadbdbcaccdadbcbabdcdb	FALSE
bbdbcbdaabdaddadbccdadacb	TRUE
cbdbcbdaabdaddadbccdadacb	FALSE
bbdcbdcddbaaddcaddcdcbacdb	TRUE
cbdcbdcddbaaddcaddcdcbacdb	FALSE
bbddbaddccdaacacbdddbabcba	TRUE
cbddbaddccdaacacbdddbabcba	FALSE
bbaabccddabcababadbcbacaca	TRUE
dbaabccddabcababadbcbacaca	FALSE
bbabcaadcaddcbacbaaddbdcda	TRUE
dbabcaadcaddcbacbaaddbdcda	FALSE
bbacbcaabdbdbddbcbaadaaddc	TRUE
dbacbcaabdbdbddbcbaadaaddc	FALSE
bbadbabadacacccbacdddadbca	TRUE
dbadbabadacacccbacdddadbca	FALSE
bbcabacabdadbcccbacbabddcc	TRUE
dbcabacabdadbcccbacbabddcc	FALSE
bbcbabddcabcaacdbdacabadcd	TRUE
dbcbabddcabcaacdbdacabadcd	FALSE
bbccacdcdcdccbabaabdccaaa	TRUE
dbccacdcdcdccbabaabdccaaa	FALSE
bbcdaadbcccbccacdabccccab	TRUE
dbcdaadbcccbccacdabccccab	FALSE
bbdaaabdabccdbadbaaaacadac	TRUE
dbdaaabdabccdbadbaaaacadac	FALSE
bbdbaadbaaadaccababccdbcdd	TRUE
dbdbaadbaaadaccababccdbcdd	FALSE
bbdcaaaabdccabaabdacacabdc	TRUE
dbdcaaaabdccabaabdacacabdc	FALSE
bbdcdcccdcdbddadbcbabaddcb	TRUE
dbdcdcccdcdbddadbcbabaddcb	FALSE
bbdddbdcbdbcbcdaddbdcdbdc	TRUE
dbdddbdcbdbcbcdaddbdcdbdc	FALSE
cabbabaddbabdaaacdbdadcbcc	TRUE
cadbabaddbabdaaacdbdadcbcc	FALSE
cbbadbabccdaaaadbdaaabdba	TRUE
cbadbabccdaaaadbdaaabdba	FALSE
cbbddabcadabcdaccbddbddcd	TRUE
cbddabcadabcdaccbddbddcd	FALSE
cbbcbdcbdbcdacdbcadadababc	TRUE
cabcbdcbdbcdacdbcadadababc	FALSE
cbbabacdbabcbaddbcbadbccd	TRUE
cbcbabacdbabcbaddbcbadbccd	FALSE
cbbddaabddadaabcdcbcbabcab	TRUE
cbcddaabddadaabcdcbcbabcab	FALSE
cbbacdbdbcdccdbdbadaacccc	TRUE
ccbacdbdbcdccdbdbadaacccc	FALSE
cbbaacbcabacdaccbacbdaabab	TRUE
cdbaacbcabacdaccbacbdaabab	FALSE
cbbdcacccdbccddbdadaddcaba	TRUE
cdbdcacccdbccddbdadaddcaba	FALSE
ccbbabcbcdaaddcbabcdcbaadb	TRUE
cccbabcbcdaaddcbabcdcbaadb	FALSE
cdbbacbcdacdbaaaacdccbdcac	TRUE
cdbacbcdacdbaaaacdccbdcac	FALSE
cdcbbaccbabacddcbadcdacbcc	TRUE
cdcdbaccbabacddcbadcdacbcc	FALSE
dabbdcdcdcbaaadbadacacdcad	TRUE
daabdcdcdcbaaadbadacacdcad	FALSE
daddbbcccbccacaabcadaabdbd	TRUE
daddbcccbccacaabcadaabdbd	FALSE
dbbcccddbcbacadaacddddcaba	TRUE
dbcccddbcbacadaacddddcaba	FALSE
dbbacddbaaddcaccacdbdbdbc	TRUE
dabacddbaaddcaccacdbdbdbc	FALSE
dbbdcdbcdbcabdaadccbcbdcba	TRUE
dabdcdbcdbcabdaadccbcbdcba	FALSE
dbbcbcacdcabcabaacbdcddcd	TRUE
dbacbcacdcabcabaacbdcddcd	FALSE
dbbacdbabdccdbcbcaadacbaa	TRUE
dcbacdbabdccdbcbcaadacbaa	FALSE
dbbdbcbadbdcdbcccbaacdbadc	TRUE
dcbdbcbadbdcdbcccbaacdbadc	FALSE
dbbcbdccabadddbdbccdccdadd	TRUE
ddbcbdccabadddbdbccdccdadd	FALSE
dcbbabadcaccbabaacdcaaacdc	TRUE
dcbabadcaccbabaacdcaaacdc	FALSE
dcbbddbcdbacccaaaccdcbaddd	TRUE
dcdbddbcdbacccaaaccdcbaddd	FALSE
ddbbcbdabdabacddaaacbabcca	TRUE
ddabcbdabdabacddaaacbabcca	FALSE
aaaadbbdaabacdcbcbaaaababcbacaa	TRUE
aaaadbdaabacdcbcbaaaababcbacaa	FALSE
aabbaadcccbaddcdbdcdcddcaddaaad	TRUE
aadbaadcccbaddcdbdcdcddcaddaaad	FALSE
abbaccacbacadaadbdcbcdadacdbaba	TRUE
abaccacbacadaadbdcbcdadacdbaba	FALSE
abbdadaacdaabcadbcacddbaadbdbcc	TRUE
abdadaacdaabcadbcacddbaadbdbcc	FALSE
abbcaccadcadadaadbcdbdddbababad	TRUE
aabcaccadcadadaadbcdbdddbababad	FALSE
abbacdccbccaaaaccaddbdbadabcbc	TRUE
ababacdccbccaaaaccaddbdbadabcbc	FALSE
abbbaadcaacadbabccacbacbdcbdacb	TRUE
abdbaadcaacadbabccacbacbdcbdacb	FALSE
abbcbcccaacbaccbabaaabdacbaddba	TRUE
acbcbcccaacbaccbabaaabdacbaddba	FALSE
abbaadcbaadacdccbdbcbabdaaddaa	TRUE
adbaadcbaadacdccbdbcbabdaaddaa	FALSE
abbdbabacdcbdaadddacccbcbccdadc	TRUE
adbdbabacdcbdaadddacccbcbccdadc	FALSE
acbbddbdbadcacadcdcdcccbabcacdb	TRUE
acbdddbdbadcacadcdcdcccbabcacdb	FALSE
adabbacddcabcbabdbcaacabdcadacb	TRUE
adababacddcabcbabdbcaacabdcadacb	FALSE
adbbcddabadcbdbadbdddcaadbcbaaa	TRUE
adcbcddabadcbdbadbdddcaadbcbaaa	FALSE
bbaabdcaabcdacacddbdcbdddcddcc	TRUE
baabdcaabcdacacddbdcbdddcddcc	FALSE
bbabcadabdccbcdbaabadcdcdcdacaa	TRUE
babcadabdccbcdbaabadcdcdcdacaa	FALSE
bbacaddcbcadbccbadbcbabcddcadad	TRUE
bacaddcbcadbccbadbcbabcddcadad	FALSE
bbadabdcbcbabcabcbcbcacadacbddb	TRUE
badabdcbcbabcabcbcbcacadacbddb	FALSE
bbcaacbdbdbacbdcacddbdccbdbdccc	TRUE
bcaacbdbdbacbdcacddbdccbdbdccc	FALSE
bbcbabaaadababddbddbcaabdcadbdb	TRUE
bcbabaaadababddbddbcaabdcadbdb	FALSE
bbcbdddaadabdcacacbdbaacabacaba	TRUE
bcbdddaadabdcacacbdbaacabacaba	FALSE
bbccdaabdabcbcabdcbaaaacbcbcacd	TRUE
bccdaabdabcbcabdcbaaaacbcbcacd	FALSE
bbcdcdbcdcbcaabdcabdccacabcadba	TRUE
bcdcdbcdcbcaabdcabdccacabcadba	FALSE
bbdacdacdbcbcabaccddbcbacaaadda	TRUE
bdacdacdbcbcabaccddbcbacaaadda	FALSE
bbdbdbaabcabadabdabddcccababcaa	TRUE
bdbdbaabcabadabdabddcccababcaa	FALSE
bbdcdcacddcbdccdddcabdbdbabacdb	TRUE
bdcdcacddcbdccdddcabdbdbabacdb	FALSE
bbddddaaddaacadabcdbcdbdbcdbcca	TRUE
bddddaaddaacadabcdbcdbdbcdbcca	FALSE
bbaaddbadbdcdabcadabdaacbdbddbd	TRUE
abaaddbadbdcdabcadabdaacbdbddbd	FALSE
bbabddbcdddcacbaabcbaddcbcdaac	TRUE
ababddbcdddcacbaabcbaddcbcdaac	FALSE
bbacddaddbabddbcbdbdabccdcbcabd	TRUE
abacddaddbabddbcbdbdabccdcbcabd	FALSE
bbadddddbaabdaddcbcabadbacdbdcd	TRUE
abadddddbaabdaddcbcabadbacdbdcd	FALSE
bbcbadabdcbdcbabdcbadcabadbaddd	TRUE
abcbadabdcbdcbabdcbadcabadbaddd	FALSE
bbccacccbaadbadddababadbcdadddb	TRUE
abccacccbaadbadddababadbcdadddb	FALSE
bbcdaaddccacbdddbccdbdcbcccaadd	TRUE
abcdaaddccacbdddbccdbdcbcccaadd	FALSE
bbdaaadaadaaaabdcabddbcbccdbcbc	TRUE
abdaaadaadaaaabdcabddbcbccdbcbc	FALSE
bbdaddaccbabcacdbcbaaddadcbcdba	TRUE
abdaddaccbabcacdbcbaaddadcbcdba	FALSE
bbdbdbcccabdbcdacaabcbdbdcbdcda	TRUE
abdbdbcccabdbcdacaabcbdbdcbdcda	FALSE
bbdcdcbdcdbabadbcbdabcdabdaacab	TRUE
abdcdcbdcdbabadbcbdabcdabdaacab	FALSE
bbdddbcadbdcbdabdabcbddadddbca	TRUE
abdddbcadbdcbdabdabcbddadddbca	FALSE
bbcdddaababadababdbacabdcdcaadd	TRUE
babcdddaababadababdbacabdcdcaadd	FALSE
bbcbdacddbcbdcbddcdbdccccacbccb	TRUE
bcbcbdacddbcbdcbddcdbdccccacbccb	FALSE
bbadbdcbcbabccbdcccbaacaaaadaaa	TRUE
bdbadbdcbcbabccbdcccbaacaaaadaaa	FALSE
baabbdadccbdbdddbcdbaddddbcdbaa	TRUE
baabdadccbdbdddbcdbaddddbcdbaa	FALSE
baccbbaadbaddaabaccacaadccdcbcd	TRUE
baccbcbaadbaddaabaccacaadccdcbcd	FALSE
bbccbcdbccdcccabacdabddbdbaabdb	TRUE
bccbcdbccdcccabacdabddbdbaabdb	FALSE
bbbcdcbadaddbcddbacacbabcddddbd	TRUE
babcdcbadaddbcddbacacbabcddddbd	FALSE
bbadadcaccbadacbdababcccabcbdda	TRUE
bcadadcaccbadacbdababcccabcbdda	FALSE
bbaaadadddcaacdcdbabdccbcccadbc	TRUE
bdaaadadddcaacdcdbabdccbcccadbc	FALSE
bbcdbdddbcdcbacadaddbabdcdbcdcb	TRUE
bdcdbdddbcdcbacadaddbabdcdbcdcb	FALSE
bcbcbbaabcbaacbadccacbaccabcacd	TRUE
bcbcbaabcbaacbadccacbaccabcacd	FALSE
bdbbdadcdacdcdaaccbdbdccdcbadba	TRUE
bdabdadcdacdcdaaccbdbdccdcbadba	FALSE
bbaaacddbdbccacbabdcdcccbaddadc	TRUE
cbaaacddbdbccacbabdcdcccbaddadc	FALSE
bbabadccbdbdbaabddccdbcabdaddc	TRUE
cbabadccbdbdbaabddccdbcabdaddc	FALSE
bbacacaaacdcddcdabdabddacccacbd	TRUE
cbacacaaacdcddcdabdabddacccacbd	FALSE
bbadababcccdbadcdbddbabdcddadca	TRUE
cbadababcccdbadcdbddbabdcddadca	FALSE
bbcaacbadccbaacbdabcdcacadabccc	TRUE
cbcaacbadccbaacbdabcdcacadabccc	FALSE
bbcbaababdbcddacbadbaabdbccbcab	TRUE
cbcbaababdbcddacbadbaabdbccbcab	FALSE
bbcbddbabcccadaabccdcdcbaacbadc	TRUE
cbcbddbabcccadaabccdcdcbaacbadc	FALSE
bbccdccdcbcabdccdbdbaddbabcccd	TRUE
cbccdccdcbcabdccdbdbaddbabcccd	FALSE
bbcddddbdadcbddcbddcaaadbcdabc	TRUE
cbcddddbdadcbddcbddcaaadbcdabc	FALSE
bbdacdcddbccabddaddbaccbcacabda	TRUE
cbdacdcddbccabddaddbaccbcacabda	FALSE
bbdbcdaadadcacbcbcdcaccdbcddaca	TRUE
cbdbcdaadadcacbcbcdcaccdbcddaca	FALSE
bbdccbcdadcaabdacaabddccaacdac	TRUE
cbdccbcdadcaabdacaabddccaacdac	FALSE
bbddcabcccadcadabacccbcccbdbadd	TRUE
cbddcabcccadcadabacccbcccbdbadd	FALSE
bbaabdcbaabddadbaadbdbadabdbdac	TRUE
dbaabdcbaabddadbaadbdbadabdbdac	FALSE
bbabcbdcbccbdbaaadbaadddcabdcc	TRUE
dbabcbdcbccbdbaaadbaadddcabdcc	FALSE
bbaccadacdbddbaacadbccbaabadac	TRUE
dbaccadacdbddbaacadbccbaabadac	FALSE
bbadcbcbdbcdadbdcdbadbcdcabaadc	TRUE
dbadcbcbdbcdadbdcdbadbcdcabaadc	FALSE
bbcabdcadcacdacdaccdaacacbabacc	TRUE
dbcabdcadcacdacdaccdaacacbabacc	FALSE
bbcbcbcbadddccccddbcdcbacdadacc	TRUE
dbcbcbcbadddccccddbcdcbacdadacc	FALSE
bbccbcddcbccbadbdaacaaaccbcbdd	TRUE
dbccbcddcbccbadbdaacaaaccbcbdd	FALSE
bbcdbabddbdbadacabccccadbcadab	TRUE
dbcdbabddbdbadacabccccadbcadab	FALSE
bbdaaacbaaaaacaaddaacccbdadbaab	TRUE
dbdaaacbaaaaacaaddaacccbdadbaab	FALSE
bbdbaadabaadadaddcbaccdbabdcabc	TRUE
dbdbaadabaadadaddcbaccdbabdcabc	FALSE
bbdcaaadcbadacbcbcdbadbcdbaadbc	TRUE
dbdcaaadcbadacbcbcdbadbcdbaadbc	FALSE
bbddacaabdaadbacdcadbadacbcdadc	TRUE
dbddacaabdaadbacdcadbadacbcdadc	FALSE
caaabbcacbdddacacbaaccdccabcacd	TRUE
caaabcacbdddacacbaaccdccabcacd	FALSE
cabbaaaaddcacbcaaacbadddabacac	TRUE
cadbaaaaddcacbcaaacbadddabacac	FALSE
cbbacdababadccdadaddcdcabcbabc	TRUE
cbacdababadccdadaddcdcabcbabc	FALSE
cbbdbabdaabcdaaaaccbadbccdbdaa	TRUE
cbdbabdaabcdaaaaccbadbccdbdaa	FALSE
cbbcacdddadbabacbddadcdcbabdaab	TRUE
cabcacdddadbabacbddadcdcbabdaab	FALSE
cbbddcbadcdbaabddbccaaababcbada	TRUE
cbabddcbadcdbaabddbccaaababcbada	FALSE
cbbbdbabcacdadccbacdcbabdddabcb	TRUE
cbdbdbabcacdadccbacdcbabdddabcb	FALSE
cbbccacbcdbcbabcadbdcacbdacbcdd	TRUE
ccbccacbcdbcbabcadbdcacbdacbcdd	FALSE
cbbacacdcdbaccbdbdbacccabccbcad	TRUE
cdbacacdcdbaccbdbdbacccabccbcad	FALSE
cbbdcaddbaccccbdccaabdcabacbabc	TRUE
cdbdcaddbaccccbdccaabdcabacbabc	FALSE
ccbbcccbdaddcdcdacdbdddcccbcab	TRUE
cccbcccbdaddcdcdacdbdddcccbcab	FALSE
cdbbdcdddacaddbaababcddddbcabdd	TRUE
cdbdcdddacaddbaababcddddbcabdd	FALSE
cddbbdcaadaadccabdaadadcaaddba	TRUE
cddbcbdcaadaadccabdaadadcaaddba	FALSE
dabbcbdadddddaacaaabcccabdcdcdc	TRUE
dacbcbdadddddaacaaabcccabdcdcdc	FALSE
dbbaccbacbaabdbcdcbaaddddcaaddc	TRUE
dbaccbacbaabdbcdcbaaddddcaaddc	FALSE
dbbdcbdadbaabddcbcbdcbddbcddcad	TRUE
dbdcbdadbaabddcbcbdcbddbcddcad	FALSE
dbbccaaacdddbdaacbccbadcdbcccdd	TRUE
dabccaaacdddbdaacbccbadcdbcccdd	FALSE
dbbadcbcadddbdccccdadacbcaaaaac	TRUE
dbabadcbcadddbdccccdadacbcaaaaac	FALSE
dbbbdadcddcdbddcdaddbadaacbcccd	TRUE
dbabdadcddcdbddcdaddbadaacbcccd	FALSE
dbbacccbadcdbcbcdbcbaddddaababc	TRUE
dcbacccbadcdbcbcdbcbaddddaababc	FALSE
dbbddaabcaddbaadbadacbdabcddcdc	TRUE
dcbddaabcaddbaadbadacbdabcddcdc	FALSE
dbbcbcddbcbdadcdbdcdbdacbdbcbaa	TRUE
ddbcbcddbcbdadcdbdcdbdacbdbcbaa	FALSE
dcacdbbcbaaddddcddbcdadaccacaba	TRUE
dcacddbcbaaddddcddbcdadaccacaba	FALSE
dcccbbcdbaacbdbddaaacdbcaadaaa	TRUE
dcccdbcdbaacbdbddaaacdbcaadaaa	FALSE
ddbbdcaadccbaabaabdaabdbccdbaba	TRUE
ddbdbdcaadccbaabaabdaabdbccdbaba	FALSE
aaaabbcacdcaababccbcabcbddcadcbadabd	TRUE
aaaabcacdcaababccbcabcbddcadcbadabd	FALSE
aabbcbdcdaaaaaddcadaadbacdacaacddbdb	TRUE
aacbcbdcdaaaaaddcadaadbacdacaacddbdb	FALSE
abbaccabdaccccbacccdccdaacacddcdadcb	TRUE
abaccabdaccccbacccdccdaacacddcdadcb	FALSE
abbdcaaddbdbadbcdcbcbdadaccdcbaccccb	TRUE
abdcaaddbdbadbcdcbcbdadaccdcbaccccb	FALSE
abbcbaccacaacbcbdcacbdcdbddbdacabdb	TRUE
aabcbaccacaacbcbdcacbdcdbddbdacabdb	FALSE
abbacaaacbdbcbddabcacdbdbdbadadcccc	TRUE
ababacaaacbdbcbddabcacdbdbdbadadcccc	FALSE
abbbcbaaadbadabdacaddcacacbacbcbdcd	TRUE
abcbcbaaadbadabdacaddcacacbacbcbdcd	FALSE
abbadcbccdccacdbcaaaaabcbaaadddcabdc	TRUE
acbadcbccdccacdbcaaaaabcbaaadddcabdc	FALSE
abbabadbcdacccccdaacdabaacdaabaacacb	TRUE
adbabadbcdacccccdaacdabaacdaabaacacb	FALSE
abbcddabdaddaacbcaacabcaccddaaabcbac	TRUE
adbcddabdaddaacbcaacabcaccddaaabcbac	FALSE
acbbabadcbcadbaccdbcbcbdbaddbaaadaba	TRUE
acbcbabadcbcadbaccdbcbcbdbaddbaaadaba	FALSE
adabbdbaddcdaadabdcdbdccccdbdcadadbd	TRUE
adabddbaddcdaadabdcdbdccccdbdcadadbd	FALSE
adbbcbadbcbccccbdacadbdaaaccbaaacbab	TRUE
addbcbadbcbccccbdacadbdaaaccbaaacbab	FALSE
bbaacadcaccdcddaccacddbdcddaaadcbaad	TRUE
baacadcaccdcddaccacddbdcddaaadcbaad	FALSE
bbabccdddbacdddabddcadddaaadcbdbcaba	TRUE
babccdddbacdddabddcadddaaadcbdbcaba	FALSE
bbacbddacdbadbcbccbdadbcbddccabdabda	TRUE
bacbddacdbadbcbccbdadbcbddccabdabda	FALSE
bbadbddadbcccdcddbdabddbcabadadacdbd	TRUE
badbddadbcccdcddbdabddbcabadadacdbd	FALSE
bbcabdaccbdbddbccbddbcbddccdbacaaaa	TRUE
bcabdaccbdbddbccbddbcbddccdbacaaaa	FALSE
bbcbccbabaabcdabdabdcccaacbcbcbcacba	TRUE
bcbccbabaabcdabdabdcccaacbcbcbcacba	FALSE
bbcccbaacccbaaddbcdcadacbddacbdcbaad	TRUE
bcccbaacccbaaddbcdcadacbddacbdcbaad	FALSE
bbcdbdaddcbaabcccbcbcdbaabaaaabaccad	TRUE
bcdbdaddcbaabcccbcbcdbaabaaaabaccad	FALSE
bbdacbddddbaabccdcacbdbdababcdcbdbdd	TRUE
bdacbddddbaabccdcacbdbdababcdcbdbdd	FALSE
bbdbccababdbcaabcccadabcddccdbacdbac	TRUE
bdbccababdbcaabcccadabcddccdbacdbac	FALSE
bbdcbdddbaadacabaadaadcacacabcbcadbd	TRUE
bdcbdddbaadacabaadaadcacacabcbcadbd	FALSE
bbddbdcbdcccaaccdbcbddcbccadcdcabcda	TRUE
bddbdcbdcccaaccdbcbddcbccadcdcabcda	FALSE
bbaabcbadbabccdaddabccabdcbccadbdbac	TRUE
abaabcbadbabccdaddabccabdcbccadbdbac	FALSE
bbabadbababdcddbcaabdaadbcaabcadbaca	TRUE
ababadbababdcddbcaabdaadbcaabcadbaca	FALSE
bbacacddacbdbaaadccddbabcdbcdbaddcab	TRUE
abacacddacbdbaaadccddbabcdbcdbaddcab	FALSE
bbadaccaabcbccdcccbaacacdddbadbddcad	TRUE
abadaccaabcbccdcccbaacacdddbadbddcad	FALSE
bbcaabccdcccdcddaadadadbabdadcdccdcc	TRUE
abcaabccdcccdcddaadadadbabdadcdccdcc	FALSE
bbcaddbccbdabcdbdbdacbdaacacdaadcbaa	TRUE
abcaddbccbdabcdbdbdacbdaacacdaadcbaa	FALSE
bbcbdcdbdccaaccbcadbabdabcbccdcdbcda	TRUE
abcbdcdbdccaaccbcadbabdabcbccdcdbcda	FALSE
bbccdaabccabadddddccbaaccadbcddccad	TRUE
abccdaabccabadddddccbaaccadbcddccad	FALSE
bbcdcdadaccacbdccbadbcdacaccccbadcac	TRUE
abcdcdadaccacbdccbadbcdacaccccbadcac	FALSE
bbdacdbdbaabdbcdbcabddcabaccbdbdadcd	TRUE
abdacdbdbaabdbcdbcabddcabaccbdbdadcd	FALSE
bbdbcccbdbdbacbdaaadbacbcadabdcccbcd	TRUE
abdbcccbdbdbacbdaaadbacbcadabdcccbcd	FALSE
bbdcbcaabcaccadabdcdbccababadbcbdcad	TRUE
abdcbcaabcaccadabdcdbccababadbcbdcad	FALSE
bbddaddabdccdcdddccdddcaadcccacdcddb	TRUE
abddaddabdccdcdddccdddcaadcccacdcddb	FALSE
bbabddaddbcddbacacacbadddccdaaaaacdd	TRUE
bababddaddbcddbacacacbadddccdaaaaacdd	FALSE
bbddcbcbcdbaadaddaacbdbddcaddddddcd	TRUE
babddcbcbcdbaadaddaacbdbddcaddddddcd	FALSE
bbdcacaddbacbabccccdccdbabadddbccaa	TRUE
bcbdcacaddbacbabccccdccdbabadddbccaa	FALSE
bbdababcdbacabcbaacbccbadbcddbcbdbac	TRUE
bdbdababcdbacabcbaacbccbadbcddbcbdbac	FALSE
babbadcacddcbddaccccdccbcaaabdcadcad	TRUE
bacbadcacddcbddaccccdccbcaaabdcadcad	FALSE
bbaddadbdbabdbcbdbcacaaccdcbdccabdad	TRUE
baddadbdbabdbcbdbcacaaccdcbdccabdad	FALSE
bbacccdbdccdaadcdacdbcadacdbccdccadd	TRUE
baacccdbdccdaadcdacdbcadacdbccdccadd	FALSE
bbdcdddccccdbaccdbabacbcbdaaaaaadddc	TRUE
badcdddccccdbaccdbabacbcbdaaaaaadddc	FALSE
bbccaacaddaadccdadcabcaaacabdbabadab	TRUE
bcccaacaddaadccdadcabcaaacabdbabadab	FALSE
bbbcacbdbddddcdbabcbacacccabcdbdcaab	TRUE
bdbcacbdbddddcdbabcbacacccabcdbdcaab	FALSE
bcabbcdbaaccdccabccbddadacddcdcdcabc	TRUE
bcabdbcdbaaccdccabccbddadacddcdcdcabc	FALSE
bccbbaabdacbacbccbabddabccddccbabccb	TRUE
bccabaabdacbacbccbabddabccddccbabccb	FALSE
bdcbbabacdaabcbabcaabababaccdcabadcb	TRUE
bdcababacdaabcbabcaabababaccdcabadcb	FALSE
bbaadbaaabcdacbabdacbdbdcbcddbdccbab	TRUE
cbaadbaaabcdacbabdacbdbdcbcddbdccbab	FALSE
bbabdaaccdbcbccbdadcbabcddcccbadbddb	TRUE
cbabdaaccdbcbccbdadcbabcddcccbadbddb	FALSE
bbaccbccbcbcbdbdadbccbcbaabdbaababdb	TRUE
cbaccbccbcbcbdbdadbccbcbaabdbaababdb	FALSE
bbadcbddaccabcbdadbacccabadababacacc	TRUE
cbadcbddaccabcbdadbacccabadababacacc	FALSE
bbcacdabdacbddcabddcdbccaaaddaabdcca	TRUE
cbcacdabdacbddcabddcdbccaaaddaabdcca	FALSE
bbcbdbcbcbccccbacadcdadcbadaccbcbdda	TRUE
cbcbdbcbcbccccbacadcdadcbadaccbcbdda	FALSE
bbccdacaaacdbcccbaccbddcdcbdacbdcaba	TRUE
cbccdacaaacdbcccbaccbddcdcbdacbdcaba	FALSE
bbcdcdddbdbcdabdaddbdddbddadcdacabac	TRUE
cbcdcdddbdbcdabdaddbdddbddadcdacabac	FALSE
bbdacbccdabdabadadaadcbcccdddbcbccd	TRUE
cbdacbccdabdabadadaadcbcccdddbcbccd	FALSE
bbdbccacdabcdcbaadddccccadbaabadaabc	TRUE
cbdbccacdabcdcbaadddccccadbaabadaabc	FALSE
bbdccacaadccaacaaadabadcacddcbdbcaba	TRUE
cbdccacaadccaacaaadabadcacddcbdbcaba	FALSE
bbddbdddbddbacdabcbabdbcdcdcacbdccb	TRUE
cbddbdddbddbacdabcbabdbcdcdcacbdccb	FALSE
bbaacdcdbdaddbacdccaddbcdbdcacccbdda	TRUE
dbaacdcdbdaddbacdccaddbcdbdcacccbdda	FALSE
bbabcdccddbdbcbabcddbcdacbabdcacbada	TRUE
dbabcdccddbdbcbabcddbcdacbabdcacbada	FALSE
bbaccadbcbabacbaccdddcdbdaaacabdbacc	TRUE
dbaccadbcbabacbaccdddcdbdaaacabdbacc	FALSE
bbadcacbccccaddcccaaacaccabcbadddbcd	TRUE
dbadcacbccccaddcccaaacaccabcbadddbcd	FALSE
bbcabdacabababdccbdccadbcdacbdadabc	TRUE
dbcabdacabababdccbdccadbcdacbdadabc	FALSE
bbcbcaadddcdddcbcadcbacbddbcaabacdac	TRUE
dbcbcaadddcdddcbcadcbacbddbcaabacdac	FALSE
bbccbdaaddacbdbdddbdbcbcacdababcaccd	TRUE
dbccbdaaddacbdbdddbdbcbcacdababcaccd	FALSE
bbcdbcbdbadbaabdbdaaadbdbdcdddccdabc	TRUE
dbcdbcbdbadbaabdbdaaadbdbdcdddccdabc	FALSE
bbdabdcdccddcdbcddcadadcbdabcbccbadc	TRUE
dbdabdcdccddcdbcddcadadcbdabcbccbadc	FALSE
bbdbadcbcddccbcabcadbcadddcdbabcbddd	TRUE
dbdbadcbcddccbcabcadbcadddcdbabcbddd	FALSE
bbdcadbaabaccacdbdadcbaacadcdddcaccb	TRUE
dbdcadbaabaccacdbdadcbaacadcdddcaccb	FALSE
bbddbabddcbadcbcaabcbccacabacbcdbcad	TRUE
dbddbabddcbadcbcaabcbccacabacbcdbcad	FALSE
caabbcccaccbccaaddaaddbccacaaabcbddc	TRUE
caadbcccaccbccaaddaaddbccacaaabcbddc	FALSE
cabbccdddddadbdcdcacbcaaaacdddbadabd	TRUE
cadbccdddddadbdcdcacbcaaaacdddbadabd	FALSE
cbbcaaccccdbccaddabdcaddbadaaaaccdcb	TRUE
cbcaaccccdbccaddabdcaddbadaaaaccdcb	FALSE
cbbaaabdadbadcbacadbcaaaacccaccddddc	TRUE
cabaaabdadbadcbacadbcaaaacccaccddddc	FALSE
cbbcdacbabcbcbdcacbabcaccbdabccdcabc	TRUE
cabcdacbabcbcbdcacbabcaccbdabccdcabc	FALSE
cbbdccdadcbdaacbcbdcdddccddaadacddd	TRUE
cbcbdccdadcbdaacbcbdcdddccddaadacddd	FALSE
cbdcdbbadbdbcdbdbcbcdababdcdaacdbaa	TRUE
cbdcdbadbdbcdbdbcbcdababdcdaacdbaa	FALSE
cbbdaadabdacccbccacccbcdbaadabddaabc	TRUE
ccbdaadabdacccbccacccbcdbaadabddaabc	FALSE
cbbcababacdbdcddcbaddcccabdbcbaaabcd	TRUE
cdbcababacdbdcddcbaddcccabdbcbaaabcd	FALSE
ccabbadaadcacbaaaaccddadabcbacaabdca	TRUE
ccabadaadcacbaaaaccddadabcbacaabdca	FALSE
ccbbcbacdaaccdccbdacabaaccbadaaaccbc	TRUE
ccdbcbacdaaccdccbdacabaaccbadaaaccbc	FALSE
cdbbdddbaabcccbcbcaccdcdcdcbcdcdccc	TRUE
cdbdddbaabcccbcbcaccdcdcdcbcdcdccc	FALSE
cdcccbbacdbacadddbcdcaadbabdadccbacc	TRUE
cdcccdbacdbacadddbcdcaadbabdadccbacc	FALSE
dabbdcadbcabcdcadbabcdadacabdadcdcac	TRUE
dabcdcadbcabcdcadbabcdadacabdadcdcac	FALSE
dbbaacbadaddbcbaacddadadbdbcacddcacd	TRUE
dbaacbadaddbcbaacddadadbdbcacddcacd	FALSE
dbbcdcbcbacdbcbabdbcccacbdcbababdca	TRUE
dbcdcbcbacdbcbabdbcccacbdcbababdca	FALSE
dbbacdbdaacdbcacdbcacacaaddcacbaacaa	TRUE
dabacdbdaacdbcacdbcacacaaddcacbaacaa	FALSE
dbbdccaabcacdbaadadaccdbadbacdabccdd	TRUE
dabdccaabcacdbaadadaccdbadbacdabccdd	FALSE
dbbccdbcdccaadbaccbacddaabdcaaaadcdc	TRUE
dbccdbcdccaadbaccbacddaabdcaaaadcdc	FALSE
dbbabccbcccabacadccadbddaaccdacbacda	TRUE
dcbabccbcccabacadccadbddaaccdacbacda	FALSE
dbbcdddbdcdccababcccdbdcbacbacabaacd	TRUE
dcbcdddbdcdccababcccdbdcbacbacabaacd	FALSE
dbbadaaadcccbdbaabdbddbaabdabcbdbdd	TRUE
ddbadaaadcccbdbaabdbddbaabdabcbdbdd	FALSE
dbbdcabdbaaacdbcbabadaaadbacaadddbdd	TRUE
ddbdcabdbaaacdbcbabadaaadbacaadddbdd	FALSE
dcbbdddbabdccabddbcbdcaaacacacdbcaca	TRUE
dccbdddbabdccabddbcbdcaaacacacdbcaca	FALSE
ddbbcadabacdccaaacabcadcdadbabdcbcdb	TRUE
ddabcadabacdccaaacabcadcdadbabdcbcdb	FALSE
aaaabdccbbddbdbdddbddcdcaccbdabcabcddcacb	TRUE
aaaabdccabddbdbdddbddcdcaccbdabcabcddcacb	FALSE
aabbdcacddcbcaaccdddababacabaacbaadbdccca	TRUE
aacbdcacddcbcaaccdddababacabaacbaadbdccca	FALSE
abbacddbdabcbdbccbabccbccbabdadaaddabacad	TRUE
abacddbdabcbdbccbabccbccbabdadaaddabacad	FALSE
abbdcdcaababcadbacdcccbcdddcdcbcabadabadd	TRUE
abdcdcaababcadbacdcccbcdddcdcbcabadabadd	FALSE
abbcbdbdababcabdccbcaaddcdaccacdccdbcddbc	TRUE
aabcbdbdababcabdccbcaaddcdaccacdccdbcddbc	FALSE
abbcbddcdccdbcaccadabcdaddbdbdcbabdccdaaa	TRUE
ababcbddcdccdbcaccadabcdaddbdbdcbabdccdaaa	FALSE
abbdabaddcddbacbcacdbcdccabcbcdcaddcacdbc	TRUE
abcdabaddcddbacbcacdbcdccabcbcdcaddcacdbc	FALSE
abbcacdabacbcbccbaddcbdbcbaaacbdaaaabdbaa	TRUE
acbcacdabacbcbccbaddcbdbcbaaacbdaaaabdbaa	FALSE
abbaacadcbacdbcdcddddbdaddddddacbaacdbacd	TRUE
adbaacadcbacdbcdcddddbdaddddddacbaacdbacd	FALSE
abbcddadcdbddbdacbdbddcababcbdcdadccbabc	TRUE
adbcddadcdbddbdacbdbddcababcbdcdadccbabc	FALSE
acbbdbacacaccccdddccdaabadcdcccaaaaadacba	TRUE
acbcbdbacacaccccdddccdaabadcdcccaaaaadacba	FALSE
adabbccbabcaccaccbccacbabcaddbcaddacbccca	TRUE
adaabccbabcaccaccbccacbabcaddbcaddacbccca	FALSE
adbbdbadacabcdabadacddbabdcdacbdabcbddba	TRUE
addbdbadacabcdabadacddbabdcdacbdabcbddba	FALSE
bbaaccbddcdcbaacacaaaddccabdaacbaabacadba	TRUE
baaccbddcdcbaacacaaaddccabdaacbaabacadba	FALSE
bbabdababdbdbccdbabdcbdaabcbcaadcadcbddab	TRUE
babdababdbdbccdbabdcbdaabcbcaadcadcbddab	FALSE
bbacdaacdbdcbdaaabaaccadcbccbaaacdabcaaab	TRUE
bacdaacdbdcbdaaabaaccadcbccbaaacdabcaaab	FALSE
bbaddbdccaccbaaccdcbcaaadcadadabdabcaddbc	TRUE
baddbdccaccbaaccdcbcaaadcadadabdabcaddbc	FALSE
bbcacdcdcccccdadbdacbacdacaacdbccacadbdcd	TRUE
bcacdcdcccccdadbdacbacdacaacdbccacadbdcd	FALSE
bbcbdbdacbdbacbdccdcdcdbadcbdcbadcadddcbd	TRUE
bcbdbdacbdbacbdccdcdcdbadcbdcbadcadddcbd	FALSE
bbcccddddddaaddcdcdbabadaadadcbababccbacb	TRUE
bcccddddddaaddcdcdbabadaadadcbababccbacb	FALSE
bbcdbddbdccaddbdbcbaaaddcaadbdacccbcbccc	TRUE
bcdbddbdccaddbdbcbaaaddcaadbdacccbcbccc	FALSE
bbdacadcabccddccbcdbddccbaabdcbaabcdcdddc	TRUE
bdacadcabccddccbcdbddccbaabdcbaabcdcdddc	FALSE
bbdbcbaccdcccabacbabcddcabdccdcddcbddcbac	TRUE
bdbcbaccdcccabacbabcddcabdccdcddcbddcbac	FALSE
bbdcbcaddaabdddaadbcbdbdbababcbcbaabdaaab	TRUE
bdcbcaddaabdddaadbcbdbdbababcbcbaabdaaab	FALSE
bbddbcabccdabadddaddcabdaabccccbacaccbcba	TRUE
bddbcabccdabadddaddcabdaabccccbacaccbcba	FALSE
bbaabadccbacdadcccacccbabdaccabccccacadb	TRUE
abaabadccbacdadcccacccbabdaccabccccacadb	FALSE
bbabcabadacbaccdbdbdbcddccdaacdbdbabccadc	TRUE
ababcabadacbaccdbdbdbcddccdaacdbdbabccadc	FALSE
bbacbccbcbccadddcccdadaccadbaabaddaababcc	TRUE
abacbccbcbccadddcccdadaccadbaabaddaababcc	FALSE
bbadbcbcbabaacbdcbacbdddcbddbabadcccccddd	TRUE
abadbcbcbabaacbdcbacbdddcbddbabadcccccddd	FALSE
bbcabdabddcabadcdddbdcdcbadbcadbcadcdadda	TRUE
abcabdabddcabadcdddbdcdcbadbcadbcadcdadda	FALSE
bbcbcaadaddbdbaabaccbcdcdadbaabcdcdcbacac	TRUE
abcbcaadaddbdbaabaccbcdcdadbaabcdcdcbacac	FALSE
bbccbaaabcacccdacccadbdabddbacabacddcdabd	TRUE
abccbaaabcacccdacccadbdabddbacabacddcdabd	FALSE
bbcdbababcbcbdabdbacbccaccbccccdccabddccc	TRUE
abcdbababcbcbdabdbacbccaccbccccdccabddccc	FALSE
bbdaaacbddaacacccdbadcdaacbcbaabaacdbdbcb	TRUE
abdaaacbddaacacccdbadcdaacbcbaabaacdbdbcb	FALSE
bbdaddaacddabdaddbcdbcdddacdbacdabababcdb	TRUE
abdaddaacddabdaddbcdbcdddacdbacdabababcdb	FALSE
bbdbdccaadaacacddbabcdadcacdbcbaabdccaaba	TRUE
abdbdccaadaacacddbabcdadcacdbcbaabdccaaba	FALSE
bbdccdcababddddcdbcabcddadcdddabcbcbccad	TRUE
abdccdcababddddcdbcabcddadcdddabcbcbccad	FALSE
bbdddbabcbcababdbdcdcbcdcdaccddbabcabcccd	TRUE
abdddbabcbcababdbdcdcbcdcdaccddbabcabcccd	FALSE
bbccbcccdddbacddbddabdaaddbcbddaaccdcdbad	TRUE
babccbcccdddbacddbddabdaaddbcbddaaccdcdbad	FALSE
bbcaabaddabababacccbacacccabdacbdbdbcdaaa	TRUE
bcbcaabaddabababacccbacacccabdacbdbdbcdaaa	FALSE
bbabcdbadcabdddbacbaacaacddccbaddcccdbaca	TRUE
bdbabcdbadcabdddbacbaacaacddccbaddcccdbaca	FALSE
bbddaddbcaddcdaacdccacadbcdcdbcdabddbdbaa	TRUE
bdbddaddbcaddcdaacdccacadbcdcdbcdabddbdbaa	FALSE
bacbbcbcdbabdaccdccacbacacccaabacbdbaaaa	TRUE
baccbcbcdbabdaccdccacbacacccaabacbdbaaaa	FALSE
bbcdabaadadabccbaccdddbdaacbddccdbdadbccd	TRUE
bcdabaadadabccbaccdddbdaacbddccdbdadbccd	FALSE
bbbdbddccacbccccccddbdccbaabdacaabdacdcbd	TRUE
babdbddccacbccccccddbdccbaabdacaabdacdcbd	FALSE
bbbabaddbdabdabdcbcccdabcddbdaddbdbcaacbc	TRUE
bcbabaddbdabdabdcbcccdabcddbdaddbdbcaacbc	FALSE
bbdcbdbcaaacbdcbabcdbadadccdabacadabccdad	TRUE
bcdcbdbcaaacbdcbabcdbadadccdabacadabccdad	FALSE
bbccabaabdbabccaabcaaaaacbccccadccddaaabd	TRUE
bdccabaabdbabccaabcaaaaacbccccadccddaaabd	FALSE
bcbbccabcbadacabddacdbdbdaaadaaabdbadbdc	TRUE
bcbcccabcbadacabddacdbdbdaaadaaabdbadbdc	FALSE
bdbbddabccbccdabaabcddcdabcccbddcadcbdbdc	TRUE
bdbddabccbccdabaabcddcdabcccbddcadcbdbdc	FALSE
bbaaaaabdddcddbcbccbccdacaddbdcdacaabcacd	TRUE
cbaaaaabdddcddbcbccbccdacaddbdcdacaabcacd	FALSE
bbaadcabcdcccbabddaddbdccabdacbadcbcbccca	TRUE
cbaadcabcdcccbabddaddbdccabdacbadcbcbccca	FALSE
bbabdbdcdbabdadadcbdacddcdbdcaaacdaaccdad	TRUE
cbabdbdcdbabdadadcbdacddcdbdcaaacdaaccdad	FALSE
bbacdadaacadbacbcccdbdadbcbddccadaddcabad	TRUE
cbacdadaacadbacbcccdbdadbcbddccadaddcabad	FALSE
bbaddbabcabcddacdcdcdbddaddacdddaccdaccdc	TRUE
cbaddbabcabcddacdcdcdbddaddacdddaccdaccdc	FALSE
bbcacbddccdbabaabddadcdabcaaccabccbcadccb	TRUE
cbcacbddccdbabaabddadcdabcaaccabccbcadccb	FALSE
bbcbcbdccadbdadabaaabcaaccbdcaabdacdbaabc	TRUE
cbcbcbdccadbdadabaaabcaaccbdcaabdacdbaabc	FALSE
bbccccabddcdcdcacbaabcdbaddcddaccdbdbcbcc	TRUE
cbccccabddcdcdcacbaabcdbaddcddaccdbdbcbcc	FALSE
bbcdbdcdbadaccddccaacaddddccdacccaaadadcd	TRUE
cbcdbdcdbadaccddccaacaddddccdacccaaadadcd	FALSE
bbdabadbdacdabdabcbcabdbddcabddbcdcbdcaac	TRUE
cbdabadbdacdabdabcbcabdbddcabddbcdcbdcaac	FALSE
bbdbacbabacaabaaacabaaddbdcbdbdbddccdcaa	TRUE
cbdbacbabacaabaaacabaaddbdcbdbdbddccdcaa	FALSE
bbdcabdbccbadccbcbcbaccacdcacdbdacdcdcaac	TRUE
cbdcabdbccbadccbcbcbaccacdcacdbdacdcdcaac	FALSE
bbdcddbadcdbcbccdadacbdccaaadbdbaabdbdadd	TRUE
cbdcddbadcdbcbccdadacbdccaaadbdbaabdbdadd	FALSE
bbddddaddbcdcbdbcabdcddbcadcddadbcadbcbaa	TRUE
cbddddaddbcdcbdbcabdcddbcadcddadbcadbcbaa	FALSE
bbaacdccdddaaccdbaabcbabdaabcccbcbcababca	TRUE
dbaacdccdddaaccdbaabcbabdaabcccbcbcababca	FALSE
bbabdbaccbddabadcdcbabcaddbcabaacbacbdabc	TRUE
dbabdbaccbddabadcdcbabcaddbcabaacbacbdabc	FALSE
bbacdbcbccccbdddaabdcacaccccbccdddcaabacd	TRUE
dbacdbcbccccbdddaabdcacaccccbccdddcaabacd	FALSE
bbaddbdabdababdbccbcdbdbaaadcabdccbcdaadc	TRUE
dbaddbdabdababdbccbcdbdbaaadcabdccbcdaadc	FALSE
bbcadcdcdacbcaccdddacbdcbdbdaabdccabacda	TRUE
dbcadcdcdacbcaccdddacbdcbdbdaabdccabacda	FALSE
bbcbdcabdabadddaadbccddcabcacdbabcdddcccd	TRUE
dbcbdcabdabadddaadbccddcabcacdbabcdddcccd	FALSE
bbccdbabcccabaacdadbcddcabcbdcacbcbabccc	TRUE
dbccdbabcccabaacdadbcddcabcbdcacbcbabccc	FALSE
bbcdccdddccbdbcccdbaccdbcbadcaacbdccacdaa	TRUE
dbcdccdddccbdbcccdbaccdbcbadcaacbdccacdaa	FALSE
bbdadabadaaadadccccdadacbcbcaddccaadddbd	TRUE
dbdadabadaaadadccccdadacbcbcaddccaadddbd	FALSE
bbdbdbdacdadaadddbcbddadaadbddabdddccdbad	TRUE
dbdbdbdacdadaadddbcbddadaadbddabdddccdbad	FALSE
bbdcdacbaccbccddabccdcbcaddcbddbdccdbdba	TRUE
dbdcdacbaccbccddabccdcbcaddcbddbdccdbdba	FALSE
bbdddcbcadccdcddddcdbccccbddcdacabccaacbd	TRUE
dbdddcbcadccdcddddcdbccccbddcdacabccaacbd	FALSE
cabbacbcaccccdbcabacbdbabdaccacccabdabaaa	TRUE
cacbacbcaccccdbcabacbdbabdaccacccabdabaaa	FALSE
cbbacbabadddaaaacbadcbdcbdadacbcbcbdabada	TRUE
cbacbabadddaaaacbadcbdcbdadacbcbcbdabada	FALSE
cbbdbababacccccbaadddbadadcdccbccbddcdbac	TRUE
cbdbababacccccbaadddbadadcdccbccbddcdbac	FALSE
cbbcabacbdaddaaddaddaabadadcaddacabddbaaa	TRUE
cabcabacbdaddaaddaddaabadadcaddacabddbaaa	FALSE
cbbabdbccbadcbccdccdbccdddaadadcacdabaabd	TRUE
cbababdbccbadcbccdccdbccdddaadadcacdabaabd	FALSE
cbbaaadccdcdaaaccdbccbdbabdcbacaccbdbdcbc	TRUE
cbcaaadccdcdaaaccdbccbdbabdcbacaccbdbdcbc	FALSE
cbbabaccbcabcdaabdcacbadbcddbacaadacddbda	TRUE
ccbabaccbcabcdaabdcacbadbcddbacaadacddbda	FALSE
cbbdbcbccabcddddcdddaabddcbdadbabcaddbaaa	TRUE
ccbdbcbccabcddddcdddaabddcbdadbabcaddbaaa	FALSE
cbbcbcababcacbcdadcdaabadadacdcbdbcabdddd	TRUE
cdbcbcababcacbcdadcdaabadadacdcbdbcabdddd	FALSE
ccadbbcabcbaccccdabccdddcdabddbdbcddbdaa	TRUE
ccadbcabcbaccccdabccdddcdabddbdbcddbdaa	FALSE
ccbbcbdbcdcdacbcdbcdccbaaacbdbdbadcaddbac	TRUE
ccdbcbdbcdcdacbcdbcdccbaaacbdbdbadcaddbac	FALSE
cdbbadcbcabcdccbdddcadbccabacddadbcbdccab	TRUE
cdabadcbcabcdccbdddcadbccabacddadbcbdccab	FALSE
cddbbccccbddadbacbaadbcabdacbccbdacdddba	TRUE
cdddbccccbddadbacbaadbcabdacbccbdacdddba	FALSE
dabbccdadacbabdbaadcdcbcadbdadcabacbcbdbd	TRUE
dadbccdadacbabdbaadcdcbcadbdadcabacbcbdbd	FALSE
dbbccbcdccabaacacabdababcdbccbcabadccdaba	TRUE
dbccbcdccabaacacabdababcdbccbcabadccdaba	FALSE
dbbabcdaddddbaccabacccbcadaacdbcbdccbcbdc	TRUE
dababcdaddddbaccabacccbcadaacdbcbdccbcbdc	FALSE
dbbdbddccbcbabcdaabcaabdcbcbcbacadabcbacb	TRUE
dabdbddccbcbabcdaabcaabdcbcbcbacadabcbacb	FALSE
dbbaabcdbdadbddbdbcbcccaaacabcbacbccdbdca	TRUE
dbaaabcdbdadbddbdbcbcccaaacabcbacbccdbdca	FALSE
dbbacbadbaadcdaacddbaccdbdcbcbddadddcdddc	TRUE
dcbacbadbaadcdaacddbaccdbdcbcbddadddcdddc	FALSE
dbbdbddcccbdccadbccbabadccbdddbddbabaadac	TRUE
dcbdbddcccbdccadbccbabadccbdddbddbabaadac	FALSE
dbbccabddcbdbaaaddbccdbccbaccadcbadcdaddc	TRUE
ddbccabddcbdbaaaddbccdbccbaccadcbadcdaddc	FALSE
dcacbbccbabadccabdaacbdabacabaccdaccbabcc	TRUE
dcacabccbabadccabdaacbdabacabaccdaccbabcc	FALSE
dcbbccccacdbdddcccbccdddbdcdabdccdcababa	TRUE
dcdbccccacdbdddcccbccdddbdcdabdccdcababa	FALSE
ddbbdbcadaaaccbaacbabcdbdbcbaabdcadcdbddc	TRUE
ddabdbcadaaaccbaacbabcdbdbcbaabdcadcdbddc	FALSE
aaaabbadbdbcdccbdaaabcbdbccdcbabddcbcdaaaabcb	TRUE
aaaaabadbdbcdccbdaaabcbdbccdcbabddcbcdaaaabcb	FALSE
aabbabddbdbdaacaadacabdaacaaaaacdcddacbcbaccda	TRUE
aadbabddbdbdaacaadacabdaacaaaaacdcddacbcbaccda	FALSE
abbaddcbdbabdcbcddbabaadcaabcddcaccdcccacdbcba	TRUE
abaddcbdbabdcbcddbabaadcaabcddcaccdcccacdbcba	FALSE
abbaaabdbddaccddccadbddbdaccbaaddaccacaababaa	TRUE
aabaaabdbddaccddccadbddbdaccbaaddaccacaababaa	FALSE
abbccbabcdaaaaadbcbdcaabaadbaaaaaccacaddaaacd	TRUE
aabccbabcdaaaaadbcbdcaabaadbaaaaaccacaddaaacd	FALSE
abbdccaddccddbabddbaddddbcabcdcbdadadbcdbddaaa	TRUE
abcbdccaddccddbabddbaddddbcabcdcbdadadbcdbddaaa	FALSE
abcadbbdcdbdbacaaaababdccdcbaadcabdbacaaaadaac	TRUE
abcadabdcdbdbacaaaababdccdcbaadcabdbacaaaadaac	FALSE
abbcadbaacabcccbcacdbdcbaaabcddabacbcabcababcc	TRUE
acbcadbaacabcccbcacdbdcbaaabcddabacbcabcababcc	FALSE
abbaaabdbadaccadaccccabacadcdcacbabaabadcabcd	TRUE
adbaaabdbadaccadaccccabacadcdcacbabaabadcabcd	FALSE
abbdbaababcdccbdcdacbabccddabadabcadddaaacdbac	TRUE
adbdbaababcdccbdcdacbabccddabadabcadddaaacdbac	FALSE
acbbdcccaaacccabdbcddbabdcabaabaabdddcaddacbcc	TRUE
acbabdcccaaacccabdbcddbabdcabaabaabdddcaddacbcc	FALSE
adabbcccbcccdaabdaadadacdacddaaddcbaccdbaaaadb	TRUE
adacbcccbcccdaabdaadadacdacddaaddcbaccdbaaaadb	FALSE
adbbddbadbdaabadbdabcaabadacbcaadcadbadbcaabda	TRUE
addbddbadbdaabadbdabcaabadacbcaadcadbadbcaabda	FALSE
bbaabdacddcddccbaacdbcacacbcbddbaadbaabdaddbcb	TRUE
baabdacddcddccbaacdbcacacbcbddbaadbaabdaddbcb	FALSE
bbababccbcaaddddcccabaccddbcacdcbcddadcaabdccd	TRUE
bababccbcaaddddcccabaccddbcacdcbcddadcaabdccd	FALSE
bbabddcbdcadaabddbcdbabacdbadcdcdaabacaccaabab	TRUE
babddcbdcadaabddbcdbabacdbadcdcdaabacaccaabab	FALSE
bbadabacccbacbccccacadbdbcccbdadddcddacbcbcacd	TRUE
badabacccbacbccccacadbdbcccbdadddcddacbcbcacd	FALSE
bbcaabccdbcabacaadddddadaacbaaadacbdacbdcbcaad	TRUE
bcaabccdbcabacaadddddadaacbaaadacbdacbdcbcaad	FALSE
bbcadddddcccaacabdbacddcbdcbaccbabadbaabdaacca	TRUE
bcadddddcccaacabdbacddcbdcbaccbabadbaabdaacca	FALSE
bbccababdabccdbccddabccacaacbdbdddaaaadddcdaba	TRUE
bccababdabccdbccddabccacaacbdbdddaaaadddcdaba	FALSE
bbccdcdbcadbddbadbcaaccadabcabaababacbcbaccbcd	TRUE
bccdcdbcadbddbadbcaaccadabcabaababacbcbaccbcd	FALSE
bbcddbababaabdcbcbdaaaddbcadaddccbdaacbcbdbaac	TRUE
bcddbababaabdcbcbdaaaddbcadaddccbdaacbcbdbaac	FALSE
bbdadbaacaddbabaddbcdccbdabdbddadcaacacddacbab	TRUE
bdadbaacaddbabaddbcdccbdabdbddadcaacacddacbab	FALSE
bbdbdacdaaaccccbdcbdcccdadaaacaadcaadacddbddbd	TRUE
bdbdacdaaaccccbdcbdcccdadaaacaadcaadacddbddbd	FALSE
bbdcdacdbddcbddacdccacaaadbabccbadbcbcdabcadb	TRUE
bdcdacdbddcbddacdccacaaadbabccbadbcbcdabcadb	FALSE
bbddcdcaccaacccddcccdcbdcbabababcccabdaadacada	TRUE
bddcdcaccaacccddcccdcbdcbabababcccabdaadacada	FALSE
bbaadbcdadcbacbdadbacabaddddbcaaccbdcdabadadcc	TRUE
abaadbcdadcbacbdadbacabaddddbcaaccbdcdabadadcc	FALSE
bbabdcbabdcdccddcccabdbcdccdabadccbaccbcbdcaba	TRUE
ababdcbabdcdccddcccabdbcdccdabadccbaccbcbdcaba	FALSE
bbacdcababddbaccbcbccbcdadacbcbcdccadcbdadacad	TRUE
abacdcababddbaccbcbccbcdadacbcbcdccadcbdadacad	FALSE
bbadcddcaddcbcaacbcdccbcdcabcadcbaddaccddabdaa	TRUE
abadcddcaddcbcaacbcdccbcdcabcadcbaddaccddabdaa	FALSE
bbcaccdaaaacdcaddccccbddbdaadddacdbadbaabdddca	TRUE
abcaccdaaaacdcaddccccbddbdaadddacdbadbaabdddca	FALSE
bbcbcccdbccaabdcabddacbdcdcccbacdadcbabcdbcada	TRUE
abcbcccdbccaabdcabddacbdcdcccbacdadcbabcdbcada	FALSE
bbcccbababdbaadccdcdbacabaccbadcaddabcacbdbcbd	TRUE
abcccbababdbaadccdcdbacabaccbadcaddabcacbdbcbd	FALSE
bbcdbdaacdaaaacbccdcadaaabaacddacaacdaabcbacb	TRUE
abcdbdaacdaaaacbccdcadaaabaacddacaacdaabcbacb	FALSE
bbdabcabccadbaddccaababaadddadcdababcccbaabcab	TRUE
abdabcabccadbaddccaababaadddadcdababcccbaabcab	FALSE
bbdbccabcdbdbddbcbaccddbaabcbdaaadcdcadcbdbac	TRUE
abdbccabcdbdbddbcbaccddbaabcbdaaadcdcadcbdbac	FALSE
bbdcbdcdccdbacabcacddcbddccbcdbacddbdbdcabcbcd	TRUE
abdcbdcdccdbacabcacddcbddccbcdbacddbdbdcabcbcd	FALSE
bbddcabdbadcddcbacaadddddacbdacdbdbaadcadcdabd	TRUE
abddcabdbadcddcbacaadddddacbdacdbdbaadcadcdabd	FALSE
bbcbddcdbadbacabdaabadadaddaabdbddabdcabadbdb	TRUE
babcbddcdbadbacabdaabadadaddaabdbddabdcabadbdb	FALSE
bbadbabaadabcbabccbdacaaacddabaaddcadcacbcbdda	TRUE
bcbadbabaadabcbabccbdacaaacddabaaddcadcacbcbdda	FALSE
bbaccdcbacdcbdbcccdaaacadcbacbdcbcbadbaabdbddc	TRUE
bdbaccdcbacdcbdbcccdaaacadcbacbdcbcbadbaabdbddc	FALSE
baabbdcaddbcbabcddcabcddbdbadddddcbdababacacda	TRUE
baabdbdcaddbcbabcddcabcddbdbadddddcbdababacacda	FALSE
badbbcabdbadcbaadcbccccacccdccdcaddbdccbdbcbda	TRUE
badbcabdbadcbaadcbccccacccdccdcaddbdccbdbcbda	FALSE
bbdbaccbaadbadbaddadcabcacdabdcddcabddbccdaadb	TRUE
bdbaccbaadbadbaddadcabcacdabdcddcabddbccdaadb	FALSE
bbccacdccbaabdbaabcccdccdadbcabadaccbdccddbcbc	TRUE
baccacdccbaabdbaabcccdccdadbcabadaccbdccddbcbc	FALSE
bbbccbacccacbddbdddcadcbdbaacacdbddabdbdacdbab	TRUE
bcbccbacccacbddbdddcadcbdbaacacdbddabdbdacdbab	FALSE
bbaccbdcdcbaccbaccacadaacabdbadcbdabdddaaaaaaa	TRUE
bdaccbdcdcbaccbaccacadaacabdbadcbdabdddaaaaaaa	FALSE
bcabbdaccdadadcddcdadcddcacacbdddbccaabababcb	TRUE
bcadbdaccdadadcddcdadcddcacacbdddbccaabababcb	FALSE
bcdbbcaaaacbcdcacdcbccbdcbdcabacccbccabdddcbcd	TRUE
bcdbcaaaacbcdcacdcbccbdcbdcabacccbccabdddcbcd	FALSE
bdbbacacbddbcddbabddbaacbcccbcdbcadaaacbdadddd	TRUE
bddbacacbddbcddbabddbaacbcccbcdbcadaaacbdadddd	FALSE
bbaabdbddccadbcdcddcbccbdbaddcdbcadcadcbdcddad	TRUE
cbaabdbddccadbcdcddcbccbdbaddcdbcadcadcbdcddad	FALSE
bbabadbaabacccbcccbcadadcabcabaacbadcdccbacbaa	TRUE
cbabadbaabacccbcccbcadadcabcabaacbadcdccbacbaa	FALSE
bbacbababcccabadabccdcdcdccabcadbabababdcbaadc	TRUE
cbacbababcccabadabccdcdcdccabcadbabababdcbaadc	FALSE
bbadbadcaddabcaadbacddaabcbaabacbaaacabaabdca	TRUE
cbadbadcaddabcaadbacddaabcbaabacbaaacabaabdca	FALSE
bbcabaccbcaddbadbaccccdbcdccdcaaccdabdcbdcadcc	TRUE
cbcabaccbcaddbadbaccccdbcdccdcaaccdabdcbdcadcc	FALSE
bbcbacdaacdabdcbcccdacbaacdaabdcbadbdcabacbcdc	TRUE
cbcbacdaacdabdcbcccdacbaacdaabdcbadbdcabacbcdc	FALSE
bbccaadaababcadbdddcaccdcabcbccbdbcabacdddacb	TRUE
cbccaadaababcadbdddcaccdcabcbccbdbcabacdddacb	FALSE
bbccddcdbddcabcdbcdbaadcabcddcbacdbabacdadbdcb	TRUE
cbccddcdbddcabcdbcdbaadcabcddcbacdbabacdadbdcb	FALSE
bbdaaacdadabcbacbdcbaddbadbadacdcdccddbcdbdddb	TRUE
cbdaaacdadabcbacbdcbaddbadbadacdcdccddbcdbdddb	FALSE
bbdbaaacdacbaaadccbdadcdabddddcdcdaaccbcdbcba	TRUE
cbdbaaacdacbaaadccbdadcdabddddcdcdaaccbcdbcba	FALSE
bbdbddccbcacbcddbcacbdcbdaaddccdababcccadabdcd	TRUE
cbdbddccbcacbcddbcacbdcbdaaddccdababcccadabdcd	FALSE
bbdcdbcbaadadbadddcaddadcbdbcdabcbdaadbacddbcd	TRUE
cbdcdbcbaadadbadddcaddadcbdbcdabcbdaadbacddbcd	FALSE
bbddcdabacdbcaabaadbdcccbccbadaddcabddaccdbaba	TRUE
cbddcdabacdbcaabaadbdcccbccbadaddcabddaccdbaba	FALSE
bbaacadbabdbdcaadbccbcdbcbaddccbcccdcbdaddcbac	TRUE
dbaacadbabdbdcaadbccbcdbcbaddccbcccdcbdaddcbac	FALSE
bbabcccacdbddddadbcdbcbcdbadcccddbcbdacbddaaca	TRUE
dbabcccacdbddddadbcdbcbcdbadcccddbcbdacbddaaca	FALSE
bbacbdbaddbadddddccdbadaaaccbdcabdcbdabcdbccbc	TRUE
dbacbdbaddbadddddccdbadaaaccbdcabdcbdabcdbccbc	FALSE
bbadbdaabacdddbcdcadabdcbacbadbddbabdcaaccbdca	TRUE
dbadbdaabacdddbcdcadabdcbacbadbddbabdcaaccbdca	FALSE
bbcaadcaacbdbcbcaddbcddbabddaacadcadaadaacbddd	TRUE
dbcaadcaacbdbcbcaddbcddbabddaacadcadaadaacbddd	FALSE
bbcbabcbcbdacbabdccacdbabaaadddbabcbdcabcdbad	TRUE
dbcbabcbcbdacbabdccacdbabaaadddbabcbdcabcdbad	FALSE
bbccaadbccabaadabdbcacbabccbcbacdcbadabcdadaaa	TRUE
dbccaadbccabaadabdbcacbabccbcbacdcbadabcdadaaa	FALSE
bbcdabdadacbdcbdcacacaadcacadaccaaaacabacadbdc	TRUE
dbcdabdadacbdcbdcacacaadcacadaccaaaacabacadbdc	FALSE
bbdaaaadaaabdccbaddacccaddccbadaacaddcabadacdb	TRUE
dbdaaaadaaabdccbaddacccaddccbadaacaddcabadacdb	FALSE
bbdbabddcaddbdaaccabcababaacaacbdbaddccbdddbdc	TRUE
dbdbabddcaddbdaaccabcababaacaacbdbaddccbdddbdc	FALSE
bbdcabcdcdcddcbcbdbcbcbadccccdbcccadbddbdccbcd	TRUE
dbdcabcdcdcddcbcbdbcbcbadccccdbcccadbddbdccbcd	FALSE
bbdcdccbcbaaaddbcbabacdbddccdcacbcadcddacddbdd	TRUE
dbdcdccbcbaaaddbcbabacdbddccdcacbcadcddacddbdd	FALSE
bbdddbadbcacbdbaaddcaddddddcbcdadaccdbdcacbdaa	TRUE
dbdddbadbcacbdbaaddcaddddddcbcdadaccdbdcacbdaa	FALSE
cababbabcbcbabacbaadbdcbacddcdaabcccabcdcbacab	TRUE
cabababcbcbabacbaadbdcbacddcdaabcccabcdcbacab	FALSE
cbbaadbdbadacbcbcbdabddbaccdbdabadccdaddacdbcb	TRUE
cbaadbdbadacbcbcbdabddbaccdbdabadccdaddacdbcb	FALSE
cbbdbacbaadbcbdababcacbaaabccaadcbccdbccaaabdd	TRUE
cbdbacbaadbcbdababcacbaaabccaadcbccdbccaaabdd	FALSE
cbbcacbdbccdacbcacbacbacdaadadcdccadacdbcaacdb	TRUE
cabcacbdbccdacbcacbacbacdaadadcdccadacdbcaacdb	FALSE
cbbddbdacdacdadabacdbdbddbccadcdbcaccabcddcdac	TRUE
cbabddbdacdacdadabacdbdbddbccadcdbcaccabcddcdac	FALSE
cbbdadacdccbccdabaabccbcbabcaacccbaadbabaadda	TRUE
cbcdadacdccbccdabaabccbcbabcaacccbaadbabaadda	FALSE
cbbccadbcdaacadbccbddabcaccddadbcdccabacccdaba	TRUE
ccbccadbcdaacadbccbddabcaccddadbcdccabacccdaba	FALSE
cbbacaabccaaabcacaabadadddccaabdcbdaaabaacdccc	TRUE
cdbacaabccaaabcacaabadadddccaabdcbdaaabaacdccc	FALSE
cbbdbcacadabdccacdbdadaaadadaaadaaacdbaadbdca	TRUE
cdbdbcacadabdccacdbdadaaadadaaadaaacdbaadbdca	FALSE
ccbdaabbcbcbabaaabdbacbcadadbabdccbadbaaddada	TRUE
ccbdaadbcbcbabaaabdbacbcadadbabdccbadbaaddada	FALSE
cdbbcacdddbccccadcdbccdbcbaddcbcbcabcdbababdac	TRUE
cdbcacdddbccccadcdbccdbcbaddcbcbcabcdbababdac	FALSE
cdccabbdaaabcaadccccccdcbcdbcabcbcbcbabdbdbcd	TRUE
cdccaabdaaabcaadccccccdcbcdbcabcbcbcbabdbdbcd	FALSE
dabbdbdadccdbccdcabdccabccaaabcabcdcddabdaaaa	TRUE
daabdbdadccdbccdcabdccabccaaabcabcdcddabdaaaa	FALSE
dadcbbcaddccbcacaadaadddbccaaabdbcccabcaddcccd	TRUE
dadccbcaddccbcacaadaadddbccaaabdbcccabcaddcccd	FALSE
dbbcdcdcbdbdccbacdccaacbdacaaabcdbddacdbcadcb	TRUE
dbcdcdcbdbdccbacdccaacbdacaaabcdbddacdbcadcb	FALSE
dbbadadcbaccaaababcabcbcbcdaacccdbabccacddbacd	TRUE
dabadadcbaccaaababcabcbcbcdaacccdbabccacddbacd	FALSE
dbbdcdbdcbccdccbdabcdbdacdbabaabdcaabdaaccbccc	TRUE
dabdcdbdcbccdccbdabcdbdacdbabaabdcaabdaaccbccc	FALSE
dbbcddaabddadbacdbcbcdadbdbcdbaadbacdcbabaaadd	TRUE
dbcddaabddadbacdbcbcdadbdbcdbaadbacdcbabaaadd	FALSE
dbbabadcadadabccdddadbdadcddbadbacabdcdccadbaa	TRUE
dcbabadcadadabccdddadbdadcddbadbacabdcdccadbaa	FALSE
dbbdcabdcbcbacbabababdcababdddabdccccdcdadaddd	TRUE
dcbdcabdcbcbacbabababdcababdddabdccccdcdadaddd	FALSE
dbbcbaddbcbacbcdaababaddadcbaacbddcbaaabcabcd	TRUE
ddbcbaddbcbacbcdaababaddadcbaacbddcbaaabcabcd	FALSE
dcbbaacaccdcbddadacadcaacbdbddcbdccadadcdcdddc	TRUE
dcbaacaccdcbddadacadcaacbdbddcbdccadadcdcdddc	FALSE
dcbbccaccdaddbcbcadbdacbadbdcadbabaaddabcaaabc	TRUE
dcdbccaccdaddbcbcadbdacbadbdcadbabaaddabcaaabc	FALSE
ddbbdccabcdacbccbdbabdacacabcccdadadccadcbabd	TRUE
ddabdccabcdacbccbdbabdacacabcccdadadccadcbabd	FALSE
